陈怡蓉=Trần Di Dung
高圆圆=Cao Viên Viên
蒋欣=Tưởng Hân
霍思燕=Hoắc Tư Yến
安以轩=An Dĩ Hiên
刘品言=Lưu Phẩm Ngôn
刘晓莉=Lưu Hiểu Lị
玉笼烟=Ngọc Lung Yên
莫贝特=Mobet
洛薇雅=Lovia
拜亚姆=Bayam
雷帕德=Leopard
雅莉希亚=Alicia
戴里克=Derrick
弗纳尔=Vernal
欺诈之神=Thần lừa gạt
月城=Thành Mặt trăng
霍格=Hogg
转运仪式=Nghi thức đổi vận
永暗之河=Sông Vĩnh ám
太阳神=Thần mặt trời
马里斯=Maris
衰败君王=Quân vương Suy bại
玉望母树=Mẫu thụ Dục vọng
旧日=Old One
堕落母神=Mẫu thần Sa đoạ
原初饥饿=Nguyên sơ Đói khát
阿霍马托瓦=Ahomatova
奥赛库斯=Osykus
博努瓦=Bonoit
列奥德罗=Leodero
阿曼妮西斯=Amanisis
恩尤尼=Enuni
德米特耶夫=Dmitryev
康斯坦汀=Constantine
乌特拉夫斯基=Utravsky
缇妮科尔=Tinicole
战争天使=Thiên sứ Chiến tranh
德莱尔=Delair
帕伦克=Palenque
唐恩=Dunn
博雅尔=Boyar
希尔蒙=Hillmon
黑夜教会=Giáo hội Đêm đen
贝伦斯=Behrens
蒸汽教会=Giáo hội Hơi nước
瓦列尔=Valier
德力西=Tracy
埃斯科森=Eskosen
兰比斯=Rambis
赫温=Hervin
橘瑠衣=Tachibana Rui
皆川茜=Minagawa Akane
夏川真凉=Natsukawa Masuz
夏川真寻=Natsukawa Mahiro
在下=tại hạ
白水=Bạch Thuỷ
水管=Hose
叶月保雄=Wadzuki Yasuo
草见月=Kusami Runa
草见=Kusami
叶月=Wadzuki
保雄=Yasuo
樱原桃=Sakurabara Momo
樱原=Sakurabara
茅春=Chiharu
洋木茅春=Yoki Chiharu
椿=Tsubaki
洋木=Yoki
梦雨蝶=Mộng Vũ Điệp
小慧=Tiểu Tuệ
小雪=Tiểu Tuyết
小艳=Tiểu Diễm
小姨子=cô em vợ
蕾丝=ren
格林姆迦尔=Grimgar
格林姆迦=Grimgar
喻北=Dụ Bắc
真正的关心过=chân chính quan tâm tới
聂倩=Nhiếp Thiến
水心=Thuỷ Tâm
天野=Amano
远子=Tooko
长沙=Trường Sa
西安=Tây An
成都=Thành Đô
雪代=Yukiyo
雪代遥=Yukiyo Haruka
OL=OL
PROLOGUE=PROLOGUE
秦缙云=Tần Tấn Vân
小胖=tiểu bàn tử
玄龙=Huyền Long
商裳儿=Thương Thường Nhi
赵小草=Triệu Tiểu Thảo
王谨轩=Vương Cẩn Hiên
长夜=Trường Dạ
夏雨=Hạ Vũ
吴倩=Ngô Thiến
王天=Vương Thiên
林茂生=Lâm Mậu Sinh
卓嫣君=Trác Yên Quân
尚贤=Thượng Hiền
柴莽=Sài Mãng
侯跃=Hầu Dược
周正泉=Chu Chính Tuyền
程明乾=Trình Minh Càn
离火=Li Hoả
巽木=Tốn Mộc
坤地=Khôn Địa
坎水=Khảm Thuỷ
张易=Trương Dịch
张奉=Trương Phụng
赵宝森=Triệu Bảo Sâm
刘鑫=Lưu Hâm
耀宁=Diệu Ninh
齐云菲=Tề Vân Phỉ
金刚龟=Kim Cương Quy
恒清=Hằng Thanh
格哈=Gerha
小白=Tiểu Bạch
重六=Trọng Lục
郭重六=Quách Trọng Lục
袁大胆=Viên Đại Đảm
郭城=Quách Thành
芬列里=Fletchley
隆巴顿=Longbottom
甘乐=Cam Nhạc
方觉晓=Phương Giác Hiểu
祝韬=Chúc Thao
莫子聪=Mạc Tử Thông
金妮=Ginny
多比=Dobby
何玲玲=Hà Linh Linh
鲁伯·海格=Rubeus · Hagrid
迪佩特=Dippet
西尔瓦=Silva
陈六儿=Trần Lục Nhi
庄克=Trang Khắc
西尔瓦努斯·凯特尔伯恩=Silvanus · Kettleburn
西尔瓦努斯=Silvanus
沃伦=Warren
高尔=Goyle
克拉布=Crabbe
奇洛=Quirrell
里德尔=Riddle
费尔奇=Filch
查古斯=Chagus
冈特=Gaunt
奥利凡德=Ollivander
海格=Hagrid
庞弗雷=Pomfrey
宾斯=Binns
伦博特=Rembolt
梅林=Merlin
塞德里克=Cédric
迪安·托马斯=Dean · Thomas
李·乔丹=Lee · Jordan
菲列克斯=Felix
纳威=Navy
萨拉查·斯莱特林=Salazar · Slytherin
萨拉查=Salazar
特里劳妮=Trelawney
克莱恩=Klein
罗纳德=Ronald
平斯=Pince
斯基特=Skeeter
吉德罗=Gilderoy
丽塔=Rita
克里维=Creevey
罗恩=Ron
马尔福=Malfoy
德拉科=Draco
弗林特=Flint
斯普劳特=Sprout
洛哈特=Lockhart
吉德罗洛哈特=Gilderoy Lockhart
西弗勒斯=Severus
弗立维=Flitwick
琳达=Linda
古代魔文=cổ đại ma văn
赫敏·格兰杰=Hermione · Granger
赫敏=Hermione
格兰杰=Granger
弗雷德=Fred
安吉丽娜·约翰逊=Angelina · Johnson
艾丽娅·斯平内特=Alicia · Spinnet
艾丽娅=Alicia
斯平内特=Spinnet
安吉丽娜=Angelina
韦斯莱=Weasley
珀西·韦斯莱=Percy · Weasley
珀西=Percy
奥利弗·伍德=Oliver · Wood
伍德=Wood
芭布玲=Babbling
芭丝茜达=Bathsheda
秦源=Tần Nguyên
赵公公=Triệu công công
绍成帝=Thiệu Thành Đế
林大头=Lâm Đại Đầu
熹妃=Hi Phi
景王=Cảnh Vương
萱妃=Huyên Phi
绍成=Thiệu Thành
邓布利多=Dumbledore
沙菲克=Shafiq
麦格=McGonagall
米勒娃=Minerva
齐叔叔=Tề thúc thúc
高博光=Cao Bác Quang
高老师=Cao lão sư
高先生=Cao tiên sinh
高大松=Cao Hiểu Tùng
老罗=lão La
于敏=Vu Mẫn
出来啦=ra ngoài rồi
顾允=Cố Doãn
林云=Lâm Vân
杰伦=Kiệt Luân
陈舒=Trần Thư
奎玛=Kuima
杨峰=Dương Phong
坦尼森=Tennyson
罕姆辛=Hamsin
奥苏亚=Osuya
肯恩·布维尔=Kean · Bouvier
肯恩=Kean
布维尔=Bouvier
田英=Điền Anh
田战=Điền Chiến
田宏=Điền Hoành
纪明玉=Kỷ Minh Ngọc
柳小琳=Liễu Tiểu Lâm
施月见=Thi Nguyệt Kiến
邓华=Đặng Hoa
高饶=Cao Nhiêu
张颖=Trương Dĩnh
曲玉=Khúc Ngọc
彭承光=Bành Thừa Quang
虞桥=Ngu Kiều
钱若雨=Tiền Nhược Vũ
江定一=Giang Định Nhất
冯少坤=Phùng Thiếu Khôn
宗艳茹=Tôn Diễm Như
李怜彤=Lý Liên Đồng
施向阳=Thi Hướng Dương
朱阳=Chu Dương
董易=Đổng Dịch
贺小伟=Hạ Tiểu Vĩ
小伟=Tiểu Vĩ
邱阳=Khâu Dương
四五=bốn năm
魏胜天=Nguỵ Thắng Thiên
幻梵=Huyễn Phạm
成云=Thành Vân
聂碧流=Nhiếp Bích Lưu
潘成云=Phan Thành Vân
蒋国生=Tưởng Quốc Sinh
方同=Phương Đồng
王震=Vương Chấn
林文=Lâm Văn
银魂=Gintama
雷姆=Rem
刘月=Lưu Nguyệt
六号=số sáu
九号=số chín
王文=Vương Văn
山崎亚衣=Yamasaki Ami
初鹿野花沢=Hajikano Hana
铃木一朗=Ichiro Suzuki
神谷明日川=Kamiya Hiaki
玖号=số chín
盘古=Bàn Cổ
蕾姆=Rem
纪明珠=Kỷ Minh Châu
纽伦=Nylon
小清=tiểu Thanh
武连长=Võ liên trưởng
李志强=Lý Chí Cường
小蔓=tiểu Mạn
反力侠=Người Phản lực
阿帕斯=Apas
谢海宁=Tạ Hải Ninh
萧哥哥=Tiêu ca ca
潇潇=Tiêu Tiêu
叶大人=Diệp đại nhân
张亮=Trương Lượng
张雨馨=Trương Vũ Hinh
蓝初蝶=Lam Sơ Điệp
聂咏=Nhiếp Vịnh
杨开=Dương Khai
杜忆霜=Đỗ Ức Sương
杜小妹=Đỗ Tiểu Muội
左安=Tả An
叶逍=Diệp Tiêu
姜浮生=Khương Phù Sinh
陈光蕊=Trần Quang Nhuỵ
邢晶晶=Hình Tinh Tinh
晶晶=Tinh Tinh
齐芳=Tề Phương
楼志胜=Lâu Chí Thắng
郑丽婉=Trịnh Lệ Uyển
邢叔叔=Hình thúc thúc
陶晓飞=Đào Hiểu Phi
周正尧=Chu Chính Nghiêu
裘海琳=Cừu Hải Lâm
秦锐=Tần Duệ
张小雨=Trương Tiểu Vũ
蔡玲=Thái Linh
团团=Đoàn Đoàn
夏瑞=Hạ Thuỵ
黄振中=Hoàng Chấn Trung
闫小玲=Diêm Tiểu Linh
海南=Hải Nam
莱尔德总督=thống đốc Laird
高德瑞克少将=thiếu tướng Godric
诺姆总督=thống đốc Nonme
班子=ê-kíp
方一鸣=Phương Nhất Minh
杨妙=Dương Diệu
葛礼=Cát Lễ
龙王=Long Vương
宇智波启=Uchiha Kei
宇智波=Uchiha
姜兰=Khương Lan
杨胄=Dương Trụ
黄滚=Hoàng Cổn
斯卡蒂亚=Scartia
暮光=Mộ Quang
落霜=Lạc Sương
方志荣=Phương Chí Vinh
唐越=Đường Việt
科斯=Coase
王烨=Vương Diệp
婉清=Uyển Thanh
吴世通=Ngô Thế Thông
程启力=Trình Khải Lực
宋璃=Tống Ly
蒋飞=Tưởng Phi
杜力宇=Đỗ Lực Vũ
M国=Mỹ Quốc
神速侠=The Flash
毛晓飞=Mao Hiểu Phi
金涛=Kim Đào
婉卿=Uyển Khanh
周远宁=Chu Viễn Ninh
毛晓非=Mao Hiểu Phi
蔓姐=Mạn tỷ
叶小姐=Diệp tiểu thư
叶悠婷=Diệp Du Đình
于海潮=Vu Hải Triều
秦志林=Tần Chí Lâm
白夜=Bạch Dạ
主网=Main Net
塔拉斯=Talas
刘应龙=Lưu Ứng Long
埃尔南=Hernan
皮萨罗=Pizarro
弗朗西斯科·皮萨罗=Francesco · Pizarro
科尔特斯=Cortés
刚铎=Gondor
陆洋=Lục Dương
艾尔利克=Elric
路爷=Lộ gia
秦怀玉=Tần Hoài Ngọc
费三立=Phí Tam Lập
季兰=Quý Lan
古震=Cổ Chấn
古岳=Cổ Nhạc
白莫邪=Bạch Mạc Tà
白铃铃=Bạch Linh Linh
甄焕生=Chân Hoán Sinh
历晓远=Lịch Hiểu Viễn
乐云=Nhạc Vân
黄玲=Hoàng Linh
莎莉=Sally
蔡敏=Thái Mẫn
温子仁=James Wan
武哲王爷=Võ Triết vương gia
朗道=Landau
崔蔓=Thôi Mạn
叶婉清=Diệp Uyển Thanh
崔长官=Thôi trưởng quan
林女士=Lâm nữ sĩ
林天南=Lâm Thiên Nam
李元嘉=Lý Nguyên Gia
刘信达=Lưu Tín Đạt
老福特=Lofter
陈狗=Trần Cẩu
狄怀英=Địch Hoài Anh
怀英=Hoài Anh
加拉德=Garad
帕托=Pato
梁建方=Lương Kiến Phương
崔义玄=Thôi Nghĩa Huyền
卡萨多利亚=Tạp Tát Đa Lợi Á
波鲁=Polu
南特=Nantes
程铁牛=Trình Thiết Ngưu
殷不破=Ân Bất Phá
王笑=Vương Tiếu
青面兽=Thanh Diện Thú
祁远=Kỳ Viễn
程氏=Trình thị
程头儿=Trình đầu nhi
程哥=Trình ca
石超=Thạch Siêu
老谢=lão Tạ
桓歆=Hoàn Hâm
谢某=Tạ mỗ
谢无奕=Tạ Vô Dịch
桓老三=Hoàn lão tam
崔浩然=Thôi Hạo Nhiên
陈叔达=Trần Thúc Đạt
岑清影=Sầm Thanh Ảnh
陈达=Trần Đạt
承烈=Thừa Liệt
苏定方=Tô Định Phương
范平=Phạm Bình
夜妖=Dạ Yêu
史同叔=Sử Đồng Thúc
阿巫=A Vu
紫丫头=Tử nha đầu
岳鸟人=Nhạc điểu nhân
岳贼=Nhạc tặc
朱老头=Chu lão đầu
徐君房=Từ Quân Phòng
许师兄=Hứa sư huynh
许万年=Hứa Vạn Niên
瞿辉=Cù Huy
刘善因=Lưu Thiện Nhân
张玄素=Trương Huyền Tố
卢承烈=Lư Thừa Liệt
卢承泰=Lư Thừa Thái
李淳风=Lý Thuần Phong
秦九道=Tần Cửu Đạo
卢蓉蓉=Lư Dung Dung
卢姗姗=Lư San San
伦也=Tomoya
亥乌儿=Heyur
莫洛佐夫=Morozov
安艺=Aki
李德奖=Lý Đức Tưởng
伦理君=Rinri-kun
加藤=Katou
诗羽=Utaha
鬼只=Yêu quỷ
卢承嗣=Lư Thừa Tự
何宝=Hà Bảo
浅井=Narumi
霞诗子=Kasumi Utako
黎小文=Lê Tiểu Văn
吴猛=Ngô Mãnh
崔君肃=Thôi Quân Túc
秦勇=Tần Dũng
崔礼=Thôi Lễ
赵慈皓=Triệu Từ Hạo
杨岌=Dương Ngập
突利=Đột Lợi
契苾何=Khế Bật Hà
颉利=Hiệt Lợi
郑善果=Trịnh Thiện Quả
葛俊飞=Cát Tuấn Phi
郑善愿=Trịnh Thiện Nguyện
郑仁基=Trịnh Nhân Cơ
孔胤达=Khổng Dận Đạt
韦尼子=Vi Ni Tử
荻原明=Ogiwara Akira
荻原=Ogiwara
卢宽=Lư Khoan
李君羡=Lý Quân Tiễn
祖明=Tổ Minh
比尔·奥克斯=Bill · Oaks
奥克斯=Oaks
蒙克=Munch
祭文略=Tế Văn Lược
弗朗西斯·蒙克=Francis · Munch
D·多比=D · Dobby
费奇=Fage
约翰·弗罗斯特=John · Frost
弗罗斯特=Frost
厄克特=Urquhart
权万纪=Quyền Vạn Kỷ
孙伏伽=Tôn Phục Già
老功=lão Công
长孙无垢=Trường Tôn Vô Cấu
卢承祖=Lư Thừa Tổ
卢恪=Lư Khác
贝老板=Bối lão bản
小媚=Tiểu Mị
李成军=Lý Thành Quân
刘成军=Lưu Thành Quân
窦义=Đậu Nghĩa
封德彝=Phong Đức Di
苏小媚=Tô Tiểu Mị
许敬宗=Hứa Kính Tông
崔仁师=Thôi Nhân Sư
贝姐=Bối tỷ
李飞=Lý Phi
李星=Lý Tinh
陈贝贝=Trần Bối Bối
贝贝=Bối Bối
独孤怀恩=Độc Cô Hoài Ân
莫尔=Merle
高德瑞克=Godric
陈哲文=Trần Triết Văn
密斯拉=Mithra
女神密斯拉=nữ thần Mithra
罗丝=Lolth
邢橙=Hình Tranh
李爱苹=Lý Ái Tần
橙橙=Tranh Tranh
柳琴=Liễu Cầm
程俊=Trình Tuấn
陈凯=Trần Khải
李颖=Lý Dĩnh
沐橙=Mộc Tranh
苏姐姐=Tô tỷ tỷ
姜峰=Khương Phong
黄小青=Hoàng Tiểu Thanh
柳橙=Liễu Tranh
周成功=Chu Thành Công
萧禹=Tiêu Vũ
小军军=tiểu Quân Quân
薛仁杲=Tiết Nhân Cảo
浑干=Hồn Can
宗罗睺=Tông La Hầu
郝瑗=Hác Viện
刘武周=Lưu Vũ Chu
莹莹=Oánh Oánh
崔莹莹=Thôi Oánh Oánh
崔宏道=Thôi Hoành Đạo
宋琼姿=Tống Quỳnh Tư
吴寻安=Ngô Tầm An
明艾=Minh Ngải
苏叶=Tô Diệp
胡帅=Hồ Soái
刘军=Lưu Quân
风花=Phong Hoa
雪月=Tuyết Nguyệt
许彤=Hứa Đồng
罗仪=La Nghi
何洛=Hà Lạc
何先生=Hà tiên sinh
王然=Vương Nhiên
孟宪华=Mạnh Hiến Hoa
武巍=Võ Nguy
·道尔=· Doyle
柯斯米斯基=Kozminsk
维克多=Victor
凯莉=Kelly
戈德温=Godwine
席格=Siegel
惠斯勒=Whistler
岑文本=Sầm Văn Bản
卢庆=Lư Khánh
拉斯克=Lasker
柯南道尔=Conan Doyle
梁一凡=Lương Nhất Phàm
钱东楼=Tiền Đông Lâu
游芳芳=Du Phương Phương
潘雪=Phan Tuyết
庄小君=Trang Tiểu Quân
郭青=Quách Thanh
林桦=Lâm Hoa
李懋=Lý Mậu
徐秋白=Từ Thu Bạch
孙剑=Tôn Kiếm
吴冬=Ngô Đông
董霸先=Đổng Bá Tiên
玛莎=Martha
秦默=Tần Mặc
珂珂=Kha Kha
小珂=tiểu Kha
喆珂=Triết Kha
汤文=Thang Văn
阿强=a Cường
张敬业=Trương Kính Nghiệp
赵强=Triệu Cường
邱志高=Khâu Chí Cao
老邱=lão Khâu
陈其焘=Trần Kỳ Đảo
彭乐云=Bành Nhạc Vân
任莉=Nhậm Lỵ
秋沁=Thu Thấm
舒蕤=Thư Nhuy
陈长华=Trần Trường Hoa
澹台翠花=Đạm Đài Thuý Hoa
德蒙=Demond
程涛=Trình Đào
查尔斯·文恩=Charles · Vanel
凯文·兰金=Kevin · Rankin
林缺=Lâm Khuyết
董秋沁=Đổng Thu Thấm
严喆珂=Nghiêm Triết Kha
蔡宗明=Thái Tông Minh
楼成=Lâu Thành
黄天化=Hoàng Thiên Hoá
天化=Thiên Hoá
韩东江=Hàn Đông Giang
邓文生=Đặng Văn Sinh
小巧儿=tiểu Xảo Nhi
黄天爵=Hoàng Thiên Tước
殷郊=Ân Giao
姜环=Khương Hoàn
苏娘娘=Tô nương nương
苏全忠=Tô Toàn Trung
许叔=chú Hứa
崇候虎=Sùng Hầu Hổ
费仲=Phí Trọng
尤浑=Vưu Hồn
崇黑虎=Sùng Hắc Hổ
曲香茹=Khúc Hương Như
桑显和=Tang Hiển Hoà
妍儿=Nghiên Nhi
白鲟=Bạch Tầm
德洛丽丝=Dolores
周常=Chu Thường
盖尔特=Galt
哈尔=Haar
卡塔莉娜·奥克兰=Katalina · Auckland
克莱因=Klein
唐斯顿=Donston
雷纳德=Leonard
蒂娅=Tia
希尔薇=Hilvy
道尔=Doyle
奎茵=Quinn
亚瑟=Arthur
卡塔莉娜=Katalina
雅各布=Jacobs
伊顿=Eaton
曼斯=Mance
路德维克=Ludwik
平克曼=Pinkerman
卡斯特=Caster
夏洛特·德·卡斯特尔=Charlotte De Caster
夏洛特=Charlotte
怀科洛=Waikoloa
艾德=Ed
艾德加=Edgar
布恩=Buan
刘卿=Lưu khanh
刘立德=Lưu Lập Đức
楚晚灵=Sở Vãn Linh
晚灵=Vãn Linh
莫友善=Mạc Hữu Thiện
莫大叔=Mạc đại thúc
杨氏=Dương thị
徐尚书=Từ thượng thư
徐有谦=Từ Hữu Khiêm
杨宁儿=Dương Ninh Nhi
徐姨娘=Từ di nương
沐公子=Mộc công tử
花姬=Hoa Cơ
雪姐姐=Tuyết tỷ tỷ
月姬=Nguyệt Cơ
楚稚=Sở Trì
雪姬=Tuyết Cơ
慧空=Tuệ Không
李婉儿=Lý Uyển Nhi
韦挺=Vi Đĩnh
荣公公=Vinh công công
李宏芝=Lý Hoành Chi
雷永吉=Lôi Vĩnh Cát
骨仪=Cốt Nghi
房氏=Phòng thị
房彦谦=Phòng Ngạn Khiêm
玄龄=Huyền Linh
许峰=Hứa Phong
周洁=Chu Khiết
林风=Lâm Phong
秦广东=Tần Quảng Đông
悠水=Du Thuỷ
秦悠水=Tần Du Thuỷ
西卡罗=Sicalo
吴老=Ngô lão
潘玲玲=Phan Linh Linh
赵航=Triệu Hàng
凯奥斯=Kaios
潘莉莉=Phan Lily
沐长卿=Mộc Trường Khanh
许浅浅=Hứa Thiển Thiển
阿俊=A Tuấn
清远=Thanh Viễn
陈倩=Trần Thiến
长卿=Trường Khanh
陈俊=Trần Tuấn
韦思齐=Vi Tư Tề
韦思仁=Vi Tư Nhân
欧阳锋=Âu Dương Phong
阴弘智=Âm Hoằng Trí
药师=Dược Sư
宇文成都=Vũ Văn Thành Đô
韦氏=Vi thị
张出尘=Trương Xuất Trần
韩擒虎=Hàn Cầm Hổ
韦思言=Vi Tư Ngôn
韦园成=Vi Viên Thành
韦匡伯=Vi Khuông Bá
姚思廉=Diêu Tư Liêm
杨素=Dương Tố
王杰=Vương Kiệt
赵哥=Triệu ca
楚含韵=Sở Hàm Vận
余裔=Dư Duệ
赵志飞=Triệu Chí Phi
袁兮兮=Viên Hề Hề
段成=Đoạn Thành
邹发=Trâu Phát
孙祥=Tôn Tường
张杰=Trương Kiệt
王黑子=Vương Hắc Tử
刘俊=Lưu Tuấn
葛公公=Cát công công
于铁头=Vu đầu sắt
葛云泰=Cát Vân Thái
骆宾王=Lạc Tân Vương
雨阉狗=Vũ chó thiến
柴可钰=Sài Khả Ngọc
柴慎=Sài Thận
云箫=Vân Tiêu
韩小莹=Hàn Tiểu Oánh
唐晓澜=Đường Hiểu Lan
厉盼归=Lệ Phán Quy
姬晓风=Cơ Hiểu Phong
孟神通=Mạnh Thần Thông
秦锦儿=Tần Cẩm Nhi
芸梦=Vân Mộng
林奇=Lâm Kỳ
杨天清=Dương Thiên Thanh
杨天=Dương Thiên
邹渊=Trâu Uyên
萧天君=Tiêu Thiên Quân
云萧=Vân Tiêu
丘氏=Khâu thị
丘行恭=Khâu Hành Cung
周万元=Chu Vạn Nguyên
左丘伊人=Tả Khâu Y Nhân
兰小宛=Lan Tiểu Uyển
刘封=Lưu Phong
孙小红=Tôn Tiểu Hồng
黑箭尊者=Hắc Tiễn tôn giả
铜雀秘者=Đồng Tước bí giả
薛仲=Tiết Trọng
小慕容=tiểu Mộ Dung
紫儿=Tử Nhi
灵紫儿=Linh Tử Nhi
波难=Ba Nan
齐风=Tề Phong
何柏谷=Hà Bách Cốc
谷崎田=Tanizaki Ta
吕千寻=Lã Thiên Tầm
吕入门=Lã Nhập Môn
森下三敬=Sankei Morishita
刘少兵=Lưu Thiếu Binh
李乾钧=Lý Càn Quân
甲尔布=Giáp Nhĩ Bố
夏鹿鸣=Hạ Lộc Minh
林雪=Lâm Tuyết
何大爷=Hà đại gia
赵祁=Triệu Kỳ
罗捷=La Tiệp
何云飞=Hà Vân Phi
刘子琪=Lưu Tử Kỳ
乐乐=Lạc Lạc
刘子乐=Lưu Tử Lạc
麻掌门=Ma chưởng môn
子余=Tử Dư
李德福=Lý Đức Phúc
陈金城=Trần Kim Thành
王大为=Vương Đại Vi
庄田光=Trang Điền Quang
叶念辉=Diệp Niệm Huy
高锦堂=Cao Cẩm Đường
刘子余=Lưu Tử Dư
卫文升=Vệ Văn Thăng
朱粲=Chu Xán
刘炅=Lưu Cảnh
裴行俨=Bùi Hành Nghiễm
徐圆朗=Từ Viên Lãng
李仲文=Lý Trọng Văn
向善志=Hướng Thiện Chí
丘师利=Khâu Sư Lợi
卫青=Vệ Thanh
马三宝=Mã Tam Bảo
何潘仁=Hà Phan Nhân
崔思华=Thôi Tư Hoa
梅先文=Mai Tiên Văn
刘云飞=lưu Vân Phi
柴容=Sài Dung
李神通=Lý Thần Thông
秀宁=Tú Ninh
屈突通=Khuất Đột Thông
墨芸儿=Mặc Vân Nhi
丫丫=Nha Nha
东方玉=Đông Phương Ngọc
董何晴=Đổng Hà Tình
方灵月=Phương Linh Nguyệt
白万剑=Bạch Vạn Kiếm
石破天=Thạch Phá Thiên
贸易与财富女神渥金=nữ thần buôn bán cùng tài phú Waukeen
渥金=Waukeen
司徒色=Tư Đồ Sắc
憎恨之神薛佛拉斯=thần căm hận Chevras
柴氏=Sài thị
水心玥=Thuỷ Tâm Nguyệt
塞拉尔=Sellar
赵九=Triệu Cửu
莫寒霜=Mạc Hàn Sương
大衮=Dagon
约翰.康纳=John Connor
阿夏=A Hạ
谎言之神希瑞克=thần nói dối Cyric
赵信博=Triệu Tín Bác
夏茴=Hạ Hồi
陆安=Lục An
小萝=Tiểu La
巴姆=Bam
刘文彩=Lưu Văn Thải
殷开山=Ân Khai Sơn
洪振华=Hồng Chấn Hoa
包利辛=Bao Lợi Tân
吕通鹰=Lã Thông Ưng
云征王=Vân Chinh Vương
李世坤=Lý Thế Khôn
马奎=Mã Khuê
陆仁=Lục Nhân
谢封=Tạ Phong
姜侯=Khương Hầu
肖九酒=Tiêu Cửu Tửu
乌三炮=Ô Tam Pháo
郑国雄=Trịnh Quốc Hùng
刘慧珍=Lưu Tuệ Trân
刘德山=Lưu Đức Sơn
薛甲宏=Tiết Giáp Hoành
晨雪=Thần Tuyết
贺晨雪=Hạ Thần Tuyết
贺昌龙=Hạ Xương Long
胖国华=Bàn Quốc Hoa
季赫明=Quý Hách Minh
林天葬=Lâm Thiên Táng
陈无生=Trần Vô Sinh
陈弘图=Trần Hoằng Đồ
古剑凌=Cổ Kiếm Lăng
査珠香=Tra Châu Hương
伊格尔=Iger
薛佛拉斯=Chevras
佛拉斯=Foras
塞尔=Searle
闫寒炆=Diêm Hàn Văn
李秀宁=Lý Tú Ninh
昌青=Xương Thanh
建成=Kiến Thành
况国华=Huống Quốc Hoa
况老板=Huống lão bản
萱儿=Huyên nhi
朱平=Chu Bình
朱志树=Chu Chí Thụ
jim phelps=Jim Phelps
佳苑=Giai Uyển
郑晋=Trịnh Tấn
辛小智=Tân Tiểu Trí
康永志=Khang Vĩnh Chí
彭佳苑=Bành Giai Uyển
风常青=Phong Thường Thanh
张克侠=Trương Khắc Hiệp
唐博豪=Đường Bác Hào
艾鹏=Ngải Bằng
石雪薇=Thạch Tuyết Vi
王哲=Vương Triết
穆英豪=Mục Anh Hào
白世辉=Bạch Thế Huy
钱壮飞=Tiền Tráng Phi
徐恩曾=Từ Ân Tằng
张冲=Trương Xung
李钰=Lý Ngọc
古老板=Cổ lão bản
刘湘=Lưu Tương
刘文辉=Lưu Văn Huy
韩成=Hàn Thành
钱户森=Tiền Hộ Sâm
李虎=Lý Hổ
户森=Hộ Sâm
杨志勇=Dương Chí Dũng
索莱顿=Soliton
特库姆塞=Tecumseh
安期生=An Kỳ Sinh
伊德里尔=Idril
德里尔=Idril
宋老生=Tống Lão Sinh
王珪=Vương Khuê
侯君集=Hầu Quân Tập
明月=Minh Nguyệt
魏大勋=Nguỵ Đại Huân
梅艳芳=Mai Diễm Phương
诺姆=Nonme
索恩=Sorn
多克萨拉姆=Doksalam
杨正道=Dương Chính Đạo
赵毅=Triệu Nghị
燕五口=Yến Ngũ Khẩu
血慕=Huyết Mộ
曹强=Tào Cường
图财=Đồ Tài
何姐姐=Hà tỷ tỷ
青鸾=Thanh Loan
赵安思=Triệu An Tư
柳正阳=Liễu Chính Dương
赵白=Triệu Bạch
孙欢喜=Tôn Hoan Hỉ
刘二牛=Lưu Nhị Ngưu
邓宏大=Đặng Hoành Đại
李吉=Lý Cát
吉哥=Cát ca
刘胜叔=Lưu Thắng thúc
刘胜=Lưu Thắng
卢昌富=Lư Xương Phú
照英=Chiếu Anh
阴明月=Âm Minh Nguyệt
李昞=Lý Bỉnh
阎文柏=Diêm Văn Bách
杨侑=Dương Hựu
阴氏=Âm thị
司承宣=Tư Thừa Tuyên
阴明空=Âm Minh Không
阴世师=Âm Thế Sư
张松=Trương Tùng
张兆=Trương Triệu
颜仙医=Nhan tiên y
夭儿=Yêu Nhi
颜文君=Nhan Văn Quân
颜师叔祖=Nhan sư thúc tổ
猿通天=Viên Thông Thiên
杨四海=Dương Tứ Hải
令狐二朗=Lệnh Hồ Nhị Lãng
通天大圣=Thông Thiên Đại Thánh
在下=kẻ hèn này
智云=Trí Vân
青云=Thanh Vân
卢昌庚=Lư Xương Canh
柴绍=Sài Thiệu
窦氏=Đậu thị
李元吉=Lý Nguyên Cát
刘文静=Lưu Văn Tĩnh
裴寂=Bùi Tịch
薛举=Tiết Cử
慕容萍=Mộ Dung Bình
李智云=Lý Trí Vân
暗之莎莉叶=Dark Sariel
暗之莎莉叶的=Dark Sariel
于丑丑=Vu Sửu Sửu
飞琼=Phi Quỳnh
南雪=Nam Tuyết
月天使莎莉叶=thiên sứ mặt trăng Sariel
燕儿=Yến Nhi
艾琳娜*烈=Elena * Lie
雷奥*烈=Leo * Lie
萨恩·烈=Thain · Lie
雷奥·烈=Leo · Lie
犹吉·烈=Yugi · Lie
犹吉=Yugi
斐奥·烈=Fior · Lie
古力·烈=Gulee · Lie
古力=Gulee
迦叶=Ca Diếp
杜辟武=Đỗ Tịch Võ
李烟仁=Lý Yên Nhân
曼迦叶=Mạn Ca Diếp
陆天穹=Lục Thiên Khung
血修罗=Huyết Tu La
吴军=Ngô Quân
朱沛奇=Chu Bái Kỳ
王安朝=Vương An Triều
拾叁=Thập Tam
图捌=Đồ Bát
图拾叁=Đồ Thập Tam
穆英杰=Mục Anh Kiệt
樊大富=Phàn Đại Phú
李瓜娃=Lý Qua Oa
李朝年=Lý Triều Niên
陈立夫=Trần Lập Phu
叶秀峰=Diệp Tú Phong
朱逸群=Chu Dật Quần
高子悠=Cao Tử Du
林千钧=Lâm Thiên Quân
令狐君=Lệnh Hồ Quân
绿萝=Lục La
安培晴明=Abe no Seimei
杨筠松=Dương Quân Tùng
齐东强=Tề Đông Cường
艳怡=Diễm Di
少翁=Thiếu Ông
江褶子=Giang Điệp Tử
李思维=Lý Tư Duy
何甜甜=Hà Điềm Điềm
雪怡=Tuyết Di
兰小襄=Lan Tiểu Tương
刘璐=Lưu Lộ
黎守义=Lê Thủ Nghĩa
徐大同=Từ Đại Đồng
于清廉=Vu Thanh Liêm
小羽儿=tiểu Vũ Nhi
天使莎莉叶=thiên sứ Sariel
阿柱=A Trụ
苔伊=Tey
艾琳娜=Elena
田老根=Điền Lão Căn
玉倪=Ngọc Nghê
庞大谢=Bàng Đại Tạ
张龙赵虎=Trương Long Triệu Hổ
半夏=Bán Hạ
梁媛=Lương Viện
嵇燕儿=Kê Yến Nhi
李自然=Lý Tự Nhiên
赵斯=Triệu Tư
衔烛=Hàm Chúc
节捷=Tiết Tiệp
任辰义=Nhậm Thần Nghĩa
田小仪=Điền Tiểu Nghi
小仪=Tiểu Nghi
季瓶儿=Quý Bình Nhi
阴冥王=Âm Minh Vương
雨少钦=Vũ Thiếu Khâm
嵇无命=Kê Vô Mệnh
嵇大春=Kê Đại Xuân
胡万钦=Hồ Vạn Khâm
姜伯子=Khương Bá Tử
葬青衣=Táng Thanh Y
刘少峰=Lưu Thiếu Phong
莫钦=Mạc Khâm
莫先生=Mạc tiên sinh
胡圆儿=Hồ Viên Nhi
冬呱=Đông Oa
笙儿=Sênh Nhi
季珉=Quý Mân
卢青云=Lư Thanh Vân
卢恩=Lư Ân
郑善玉=Trịnh Thiện Ngọc
李老弟=Lý lão đệ
厉天生=Lệ Thiên Sinh
厉天养=Lệ Thiên Dưỡng
颜师叔=Nhan sư thúc
卢思道=Lư Tư Đạo
老黄=lão Hoàng
二虎=Nhị Hổ
黄甲=Hoàng Giáp
孙二虎=Tôn Nhị Hổ
刘老闲=Lưu Lão Nhàn
梅丽萨=Melizza
胡先生=Hồ tiên sinh
T·霍克=T · Hawke
曾老=Tằng lão
郑氏=Trịnh thị
照秉=Chiếu Bỉnh
金鹰堂=Kim Ưng Đường
净医潭=Tịnh Y Đàm
李永年=Lý Vĩnh Niên
年哥儿=Niên ca nhi
卢植=Lư Thực
张钱子=Trương Tiền Tử
红竹儿=Hồng Trúc Nhi
武神通=Võ Thần Thông
齐得龙=Tề Đắc Long
知凡=Tri Phàm
言卿=Ngôn Khanh
杜伏威=Đỗ Phục Uy
窦建德=Đậu Kiến Đức
李密=Lý Mật
照辞=Chiếu Từ
吴德立=Ngô Đức Lập
红娥=Hồng Nga
严世美=Nghiêm Thế Mỹ
王非=Vương Phi
王二狗=Vương Nhị Cẩu
季翀=Quý Xung
洪象山=Hồng Tượng Sơn
林赫心=Lâm Hách Tâm
常蕙=Thường Huệ
季仲海=Quý Trọng Hải
季寇=Quý Khấu
卢昌宗=Lư Xương Tông
小文子=tiểu Văn Tử
潘银莲=Phan Ngân Liên
西门诚=Tây Môn Thành
铁布桩=Thiết Bố Thung
吴青=Ngô Thanh
许尤新=Hứa Vưu Tân
许吴青=Hứa Ngô Thanh
幽燕堂=U Yến Đường
大郎=Đại Lang
卢思成=Lư Tư Thành
洪大郎=Hồng Đại Lang
银莲=Ngân Liên
王大猛=Vương Đại Mãnh
杜木奇=Đỗ Mộc Kỳ
杜鹃=Đỗ Quyên
查东庆=Tra Đông Khánh
王发发=Vương Phát Phát
齐德龙=Tề Đức Long
卢照英=Lư Chiếu Anh
卢昌定=Lư Xương Định
卢明=Lư Minh
卢照秉=Lư Chiếu Bỉnh
卢春=Lư Xuân
卢照辞=Lư Chiếu Từ
顾全中=Cố Toàn Trung
厉娇龙=Lệ Kiều Long
小羽=tiểu Vũ
李堂前=Lý Đường Tiền
冷天鹰=Lãnh Thiên Ưng
林梦媛=Lâm Mộng Viện
洪知凡=Hồng Tri Phàm
秦玥儿=Tần Nguyệt Nhi
黑菱=Hắc Lăng
香君=Hương Quân
恒心=Hằng Tâm
董玥玥=Đổng Nguyệt Nguyệt
何小梅=Hà Tiểu Mai
柳香君=Liễu Hương Quân
陆舞衣=Lục Vũ Y
舞衣=Vũ Y
柳儿=Liễu Nhi
卢昌青=Lư Xương Thanh
卢昌清=Lư Xương Thanh
园雨=Viên Vũ
RK·霍克=RK · Hawke
黛尔=Dale
阿伦黛尔=Arendale
庞圆圆=Bàng Viên Viên
陈阔=Trần Khoát
严隶=Nghiêm Lệ
杨桃=Dương Đào
王骏=Vương Tuấn
付大龙=Phó Đại Long
小何=tiểu Hà
西雅=Sia
李芳=Lý Phương
吕主编=Lã chủ biên
吕忆潇=Lã Ức Tiêu
马教主=Mã giáo chủ
华仔=Lưu Đức Hoa
宁浩=Ninh Hạo
傅小姐=Phó tiểu thư
幼薇=Ấu Vi
木人张=Mộc Nhân Trương
智能儿=Trí Năng Nhi
心宁=Tâm Ninh
杨龙=Dương Long
马进良=Mã Tiến Lương
方达=Phương Đạt
李总=Lý tổng
张总=Trương tổng
常小文=Thường Tiểu Văn
方建宗=Phương Kiến Tông
卜苍洲=Bốc Thương Châu
谭鲁子=Đàm Lỗ Tử
纤羽=Tiêm Vũ
圆雨=Viên Vũ
园如=Viên Như
秋兰=Thu Lan
江歌=Giang Ca
白湘=Bạch Tương
摩芫=Ma Nguyên
无慧=Vô Tuệ
恒绝=Hằng Tuyệt
黎炆智=Lê Văn Trí
梅馨婉=Mai Hinh Uyển
袁杏儿=Viên Hạnh Nhi
周老师=Chu lão sư
高队=Cao đội
董女士=Đổng nữ sĩ
风里刀=Phong Lý Đao
顾少棠=Cố Thiếu Đường
玄夜=Huyền Dạ
马总=Mã tổng
许彤儿=Hứa Đồng Nhi
赵通=Triệu Thông
雨希=Ngữ Hi
范语希=Phạm Ngữ Hi
许芝麟=Hứa Chi Lân
高颖洁=Cao Dĩnh Khiết
小高=tiểu Cao
金老=Kim lão
金士杰=Kim Sĩ Kiệt
董小荨=Đổng Tiểu Tầm
小荨=Tiểu Tầm
雷崇正=Lôi Sùng Chính
令国洲=Lệnh Quốc Châu
素慧容=Tố Tuệ Dung
吴美慧=Ngô Mỹ Tuệ
陈炜亭=Trần Vĩ Đình
张升=Trương Thăng
李丰程=Lý Phong Trình
宋慈=Tống Từ
崇正=Sùng Chính
国洲=Quốc Châu
凌雁秋=Lăng Nhạn Thu
继学勇=Kế Học Dũng
雨化田=Vũ Hoá Điền
子越=Tử Việt
万喻楼=Vạn Dụ Lâu
周董=Chu đổng
赵怀安=Triệu Hoài An
白雪=Bạch Tuyết
钟离默=Chung Li Mặc
潘自然=Phan Tự Nhiên
冯唐=Phùng Đường
北岛=Bắc Đảo
秋桐=Thu Đồng
花臂姬=Tay Xăm-chan
老陈=lão Trần
小傅=tiểu Phó
徐朗=Từ Lãng
张导=Trương đạo
陈深=Trần Thâm
周曼=Chu Mạn
张晋中=Trương Tấn Trung
小蔡=tiểu Thái
凡力士=Phàm lực sĩ
一凡=Nhất Phàm
谭胜歌=Đàm Thắng Ca
黑骨=Hắc Cốt
万铭=Vạn Minh
龙铭=Long Minh
郑雨=Trịnh Vũ
郑羽=Trịnh Vũ
烽侯=Phong Hầu
齐杰=Tề Kiệt
朱彤=Chu Đồng
李青云=Lý Thanh Vân
始皇=Thuỷ Hoàng
廖延奇=Liệu Diên Kỳ
H·霍克=H · Hawke
小萱儿=tiểu Huyên nhi
五儿=Ngũ Nhi
霍克=Hawke
茉莉=Molly
内森=Nathan
山姆=Sam
郭怡廷=Quách Di Đình
罗杰=Roger
邱韵=Khâu Vận
小暮=tiểu Mộ
周蓉=Chu Dung
陈志=Trần Chí
狄施阗=Địch Thi Điền
小云=Tiểu Vân
贾芸=Giả Vân
小尹子=tiểu Doãn tử
齐小云=Tề Tiểu Vân
张大人=Trương đại nhân
芷月=Chỉ Nguyệt
云芷月=Vân Chỉ Nguyệt
吴世贵=Ngô Thế Quý
胡铨钰=Hồ Thuyên Ngọc
林秀茵=Lâm Tú Nhân
穆大河=Mục Đại Hà
巧儿=Xảo Nhi
苏巧儿=Tô Xảo Nhi
诸葛凤雏=Gia Cát Phượng Sồ
夏尔=Ciel
穆二河=Mục Nhị Hà
王可姬=Vương Khả Cơ
香儿=Hương Nhi
贾兰=Giả Lan
黄子越=Hoàng Tử Việt
徐志坤=Từ Chí Khôn
欣怡=Hân Di
戴总=Đới tổng
韩升=Hàn Thăng
容嬷嬷=Dung ma ma
和英=Hoà Anh
迅猛龙女士=tấn mãnh long nữ sĩ
银蝶=Ngân Điệp
叶雨茗=Diệp Vũ Mính
蔡依敏=Thái Y Mẫn
华迪=Hoa Địch
肖一凡=Tiêu Nhất Phàm
全志龙=Kwon Ji-yong
傅老师=Phó lão sư
允希姐=Doãn Hi tỷ
允希=Doãn Hi
香香=Hương Hương
羽羽=Vũ Vũ
戴荃=Đới Thuyên
黄家骏=Hoàng Gia Tuấn
薛燔=Tiết Chi Khiêm
王云冰=Vương Vân Băng
傅帝=Phó đế
傅妞=Phó nữu
傅心宁=Phó Tâm Ninh
阿伟=A Vĩ
采青=Thái Thanh
董姨=Đổng di
董导=Đổng đạo
王诺拉=Vương Nặc Lạp
小佳=tiểu Giai
王小姐=Vương tiểu thư
张瑾萱=Trương Cẩn Huyên
董魔王=Đổng ma vương
董余春=Đổng Dư Xuân
叶允希=Diệp Doãn Hi
陈老板=Trần lão bản
王欣怡=Vương Hân Di
戴晴秋=Đới Tình Thu
戴格秋=Đới Cách Thu
杜国楹=Đỗ Quốc Doanh
宁姐=Ninh tỷ
王桂宁=Vương Quế Ninh
欧颢=Âu Hạo
楠姐=Nam tỷ
吴洁楠=Ngô Khiết Nam
小临哥=tiểu Lâm ca
花花=Hoa Hoa
关晓贞=Quan Hiểu Trinh
晓贞=Hiểu Trinh
庾橙青=Dữu Tranh Thanh
那瑛=Na Anh
汪天王=Uông thiên vương
何幼薇=Hà Ấu Vi
小临=tiểu Lâm
何总=Hà tổng
王霏=Vương Phi
力宏=Lực Hoành
陈临=Trần Lâm
郭图=Quách Đồ
辛评=Tân Bình
荀谌=Tuân Kham
昭儿=Chiêu Nhi
雨村=Vũ Thôn
焦顺=Tiêu Thuận
张华=Trương Hoa
翠缕=Thuý Lâu
张诚=Trương Thành
兴儿=Hưng Nhi
雨亭=Vũ Đình
陈礼=Trần Lễ
潘龙涛=Phan Long Đào
洪星=Hồng Tinh
苏友霖=Tô Hữu Lâm
天哥=Thiên ca
张云=Trương Vân
姚瑶=Diêu Dao
赵九斤=Triệu Cửu Cân
吴天赐=Ngô Thiên Tứ
程馨馨=Trình Hinh Hinh
欧阳暮=Âu Dương Mộ
奥利维娅=Olivia
坎迪斯=Candace
利维娅=Livia
唐柔语=Đường Nhu Ngữ
展总=sếp Triển
贾雨村=Giả Vũ Thôn
刘长有=Lưu Trường Hữu
赵彦=Triệu Ngạn
侯云=Hầu Vân
赵熠=Triệu Dập
许辉=Hứa Huy
林如海=Lâm Như Hải
元春=Nguyên Xuân
文龙=Văn Long
玉钏=Ngọc Xuyến
金钏=Kim Xuyến
贾元春=Giả Nguyên Xuân
素云=Tố Vân
李纨=Lý Hoàn
米亚多德=Meyadod
阿斯兰=Aslan
白戮=Bạch Lục
唐兆天=Đường Triệu Thiên
麝月=Xạ Nguyệt
莫罗德=Morod
冯紫英=Phùng Tử Anh
赖慕荣=Lại Mộ Vinh
马托斯=Matos
白傲=Bạch Ngạo
孙乾坤=Tôn Càn Khôn
安亚丽=Aari
索西亚=Socia
德勒=Dreux
巴拉斯=Balas
希斯=Heath
肖章=Tiêu Chương
探春=Thám Xuân
马特=Matt
艾肯佛=Ashford
艾萨克斯=Isaacs
空明=Không Minh
安琪拉=Angela
钱倩倩=Tiền Thiến Thiến
刘夏天=Lưu Hạ Thiên
曾飞=Tằng Phi
马克辛=Maxim
廖然=Liệu Nhiên
张浩天=Trương Hạo Thiên
艾莉丝=Alice
金文翔=Kim Văn Tường
纪雯=Kỷ Văn
熊霸=Hùng Bá
杜方=Đỗ Phương
张耀宗=Trương Diệu Tông
魏明=Nguỵ Minh
王宁=Vương Ninh
黎霜沐=Lê Sương Mộc
古泽稷=Cổ Trạch Tắc
柳湘莲=Liễu Tương Liên
德尔洛=Dello
尹旷=Doãn Khoáng
魔尊=Ma Tôn
贾芹=Giả Cần
玄武吞宝=Huyền Vũ nuốt bảo
周福=Chu Phúc
赖升=Lại Thăng
侍书=Thị Thư
贾探春=Giả Thám Xuân
袭人=Tập Nhân
贾珍=Giả Trân
绣橘=Tú Quất
晴雯=Tình Văn
迎春=Nghênh Xuân
贾迎春=Giả Nghênh Xuân
柳五儿=Liễu Ngũ Nhi
贾政=Giả Chính
香菱=Hương Lăng
林红玉=Lâm Hồng Ngọc
司棋=Tư Kỳ
贾赦=Giả Xá
贾母=Giả Mẫu
鸳鸯=Uyên Ương
又安=Hựu An
樊蓉=Phàn Dung
樊妮=Phàn Ny
贾蔷=Giả Sắc
贾蓉=Giả Dung
宋松=Tống Tùng
书茶真人=Thư Trà chân nhân
秉忠呀=Bỉnh Trung Nha
潘独鳌=Phan Độc Ngao
贾瑞=Giả Thuỵ
人之有竅=người có khiếu huyệt
宋演=Tống Diễn
俞禄=Du Lộc
胡天仁=Hồ Thiên Nhân
胡恬逸=Hồ Điềm Dật
陈福=Trần Phúc
胡宗天=Hồ Tông Thiên
李双宝=Lý Song Bảo
唐曾嘉=Đường Tằng Gia
唐志宏=Đường Chí Hoành
胡绍木=Hồ Thiệu Mộc
钱湘琴=Tiền Tương Cầm
唐建设=Đường Kiến Thiết
湘云=Tương Vân
吴天禄=Ngô Thiên Lộc
詹天涯=Chiêm Thiên Nhai
胡长安=Hồ Trường An
瞎丙=Hạt Bính
吴姨=Ngô di
倪二=Nghê Nhị
秦可卿=Tần Khả Khanh
贾璜=Giả Hoàng
秦钟=Tần Chung
金荣=Kim Vinh
牛千瞩=Ngưu Thiên Chúc
马千瞩=Mã Thiên Chúc
来顺=Lai Thuận
胡淼=Hồ Miểu
胡钱福=Hồ Tiền Phúc
塑封袋子=túi ép plastic
胡钰=Hồ Ngọc
胡袁=Hồ Viên
胡杏=Hồ Hạnh
王柱儿=Vương Trụ Nhi
潘又安=Phan Hựu An
韦小宝=Vi Tiểu Bảo
顺唐=Thuận Đường
唐天安=Đường Thiên An
胡虎=Hồ Hổ
胡顺唐=Hồ Thuận Đường
刘振明=Lưu Chấn Minh
胡天佑=Hồ Thiên Hựu
徐浩=Từ Hạo
赵益=Triệu Ích
张炳=Trương Bính
焦大=Tiêu Đại
吴斌=Ngô Bân
吴寄湘=Ngô Ký Tương
林之孝=Lâm Chi Hiếu
吴新登=Ngô Tân Đăng
邓好时=Đặng Hảo Thì
开棺人=người mở quan
唐绍木=Đường Thiệu Mộc
唐五=Đường Ngũ
关童=Quan Đồng
公孙赋=Công Tôn Phú
王子腾=Vương Tử Đằng
薛蟠=Tiết Bàn
何三=Hà Tam
来旺=Lai Vượng
茗烟=Mính Yên
宝玉=Bảo Ngọc
周瑞=Chu Thuỵ
李贵=Lý Quý
宁茉=Ninh Mạt
平儿=Bình Nhi
宝钗=Bảo Thoa
宋雅=Tống Nhã
陶离=Đào Ly
熊卜佑=Hùng Bốc Hựu
杜雯=Đỗ Văn
董薇薇=Đổng Vi Vi
叶孟言=Diệp Mạnh Ngôn
汤梦龙=Thang Mộng Long
符大夫=bác sĩ Phù
李大民=Lý Đại Dân
李善民=Lý Thiện Dân
王加善=Vương Gia Thiện
夏翠=Hạ Thuý
鳖子门=Miết Tử Môn
尊平=Tôn Bình
郑泰=Trịnh Thái
荀攸=Tuân Du
种辑=Chủng Tập
种爱卿=Chủng ái khanh
荀大人=Tuân đại nhân
何进=Hà Tiến
董氏=Đổng thị
伏氏=Phục thị
伏寿=Phục Thọ
郭奉孝=Quách Phụng Hiếu
董爱卿=Đổng ái khanh
吕后=Lã hậu
郗曦=Si Hi
伏完=Phục Hoàn
张宇=Trương Vũ
董贵人=Đổng quý nhân
伏皇后=Phục hoàng hậu
伏后=Phục hậu
张喜=Trương Hỉ
赵温=Triệu Ôn
荀爽=Tuân Sảng
种拂=Chủng Phất
淳于嘉=Thuần Vu Gia
杨彪=Dương Bưu
张绣=Trương Tú
鸿豫=Hồng Dự
董贵妃=Đổng quý phi
文若=Văn Nhược
郗虑=Si Lự
光禄勋=Quang Lộc Huân
董将军=Đổng tướng quân
曹司空=Tào tư không
董承=Đổng Thừa
曹叔=Tào thúc
刘大炮=Lưu Đại Pháo
刘协=Lưu Hiệp
陈旭=Trần Húc
秦显=Tần Hiển
王善保=Vương Thiện Bảo
栓柱=Xuyên Trụ
赖大=Lại Đại
贾琏=Giả Liễn
王熙凤=Vương Hy Phượng
陈瑞=Trần Thuỵ
韩雪=Hàn Tuyết
百炼=Bách Luyện
赤麟=Xích Lân
曹掾=Tào Duyện
黑岭妖王=Hắc Lĩnh Yêu Vương
金院主=Kim viện chủ
樊毅=Phàn Nghị
赵长英=Triệu Trường Anh
赤麟妖皇=Xích Lân Yêu Hoàng
温秋月=Ôn Thu Nguyệt
柳青罡=Liễu Thanh Cương
柳玉颜=Liễu Ngọc Nhan
柳玉阙=Liễu Ngọc Khuyết
项院主=Hạng viện chủ
项流云=Hạng Lưu Vân
应彩衣=Ứng Thải Y
张中道=Trương Trung Đạo
柳风霜=Liễu Phong Sương
含光=Hàm Quang
柳含光=Liễu Hàm Quang
渊儿=Uyên Nhi
柳张氏=Liễu Trương thị
小影=tiểu Ảnh
承渊=Thừa Uyên
柳无痕=Liễu Vô Ngân
柳少=Liễu thiếu
尹小姐=Doãn tiểu thư
周祥=Chu Tường
孙凡=Tôn Phàm
萧正=Tiêu Chính
汉宁=Hán Ninh
晨子=Thần Tử
陈晨子=Trần Thần Tử
袁侍卫=Viên thị vệ
柳少爷=Liễu thiếu gia
子初=Tử Sơ
刘萍=Lưu Bình
刘菊=Lưu Cúc
东方凌=Đông Phương Lăng
仙炼宗=Tiên Luyện Tông
太墟之光=Thái Khư Chi Quang
赵启发=Triệu Khải Phát
跃进=Dược Tiến
林小姐=Lâm tiểu thư
柳青霜=Liễu Thanh Sương
柳画影=Liễu Hoạ Ảnh
柳赤宵=Liễu Xích Tiêu
阿渊=A Uyên
章鸿飞=Chương Hồng Phi
林会长=Lâm hội trưởng
林重山=Lâm Trọng Sơn
林少=Lâm thiếu
袁管家=Viên quản gia
林羽修=Lâm Vũ Tu
林少爷=Lâm thiếu gia
文志远=Văn Chí Viễn
刘兴=Lưu Hưng
周晓强=Chu Hiểu Cường
张美美=Trương Mỹ Mỹ
张秀=Trương Tú
钟泰丰=Chung Thái Phong
张劲光=Trương Kính Quang
亚红=Á Hồng
齐铭瑄=Tề Minh Tuyên
谢军=Tạ Quân
高景田=Cao Cảnh Điền
姚云飞=Diêu Vân Phi
周奎=Chu Khuê
刘蜜=Lưu Mật
陈远=Trần Viễn
柳叶眉=Liễu Diệp Mi
何英明=Hà Anh Minh
邱万青=Khâu Vạn Thanh
程子清=Trình Tử Thanh
姚猛=Diêu Mãnh
张晶=Trương Tinh
卞音=Biện Âm
卫荣=Vệ Vinh
刘振宇=Lưu Chấn Vũ
俞吉=Du Cát
陶静=Đào Tĩnh
洪建坡=Hồng Kiến Pha
刘明浩=Lưu Minh Hạo
白逸仙=Bạch Dật Tiên
项天啸=Hạng Thiên Khiếu
张院主=Trương viện chủ
张恒=Trương Hằng
傅伯=Phó bá
高渐飞=Cao Tiệm Phi
玉蝉=Ngọc Thiền
尹少宗主=Doãn thiếu tông chủ
傅长老=Phó trưởng lão
傅星云=Phó Tinh Vân
玉婵=Ngọc Thiền
曹秀荣=Tào Tú Vinh
太一=Thái Nhất
尹清霜=Doãn Thanh Sương
天霜剑=Thiên Sương Kiếm
卡丽娜=Karina
尹玉婵=Doãn Ngọc Thiền
渊少=Uyên thiếu
柳风雪=Liễu Phong Tuyết
方道衍=Phương Đạo Diễn
袁海=Viên Hải
袁峰=Viên Phong
辕乘=Viên Thừa
六福=Lục Phúc
柳承渊=Liễu Thừa Uyên
林雪薇=Lâm Tuyết Vi
马道卡=Madoca
李子平=Lý Tử Bình
李师弟=Lý sư đệ
小明=Tiểu Minh
苏护=Tô Hộ
冀州侯=Ký Châu Hầu
郑某=Trịnh mỗ
郑伦=Trịnh Luân
闻太师=Văn thái sư
闻仲=Văn Trọng
帝乙=Đế Ất
武成王=Võ Thành Vương
黄飞虎=Hoàng Phi Hổ
度厄真人=Độ Ách Chân Nhân
黄天禄=Hoàng Thiên Lộc
殷洪=Ân Hồng
木吒=Mộc Tra
金吒=Kim Tra
商容=Thương Dung
李金吒=Lý Kim Tra
李木吒=Lý Mộc Tra
殷素知=Ân Tố Tri
博德=Bác Đức
帝辛=Đế Tân
尹神=Doãn Thần
徐松=Từ Tùng
张金成=Trương Kim Thành
王骏脸色=Vương Tuấn Kiểm
李汉文=Lý Hán Văn
贾翠玉=Giả Thuý Ngọc
邓克凡=Đặng Khắc Phàm
夏盈=Hạ Doanh
刘悦=Lưu Duyệt
牛永福=Ngưu Vĩnh Phúc
宝华=Bảo Hoa
刘景阳=Lưu Cảnh Dương
夏兰=Hạ Lan
叶培根=Diệp Bồi Căn
尤国=Vưu Quốc
江岚=Giang Lam
王明=Vương Minh
雷涛=Lôi Đào
马易=Mã Dịch
夏娥=Hạ Nga
尤岚=Vưu Lam
奇洛斯基=Czylowski
姝姝=Thù Thù
蒙蒂斯=Montis
晴儿=Tình nhi
曲朗=Khúc Lãng
曲楷=Khúc Giai
袁彬=Viên Bân
子妗=Tử Cấm
苏子妗=Tô Tử Cấm
程明秀=Trình Minh Tú
金贞贞=Kim Jeong-jeong
昇龙鼎=Thăng Long Đỉnh
苏照=Tô Chiếu
胡德=Hood
马三=Mã Tam
小陌=tiểu Mạch
苏陌=Tô Mạch
柳雨梨=Liễu Vũ Lê
东方兄弟=Đông Phương huynh đệ
陈落=Trần Lạc
侯安=Hầu An
万安伯=Vạn An Bá
陈不器=Trần Bất Khí
杨子云=Dương Tử Vân
颜百川=Nhan Bách Xuyên
叶桓=Diệp Hoàn
刘响=Lưu Hưởng
梓潼=Tử Đồng
纪仲=Kỷ Trọng
杜晓曼=Đỗ Hiểu Mạn
刘建真=Lưu Kiến Chân
陈小家主=Trần tiểu gia chủ
同尘=Đồng Trần
白昌植=Bạch Xương Thực
夏珂=Hạ Kha
夏源=Hạ Nguyên
荆怡=Kinh Di
荆薇=Kinh Vi
夏姝=Hạ Thù
刘淼=Lưu Miểu
赵珊=Triệu San
魏焱=Nguỵ Diễm
天一=Thiên Nhất
李如夜=Lý Như Dạ
夏晴=Hạ Tình
老钟=lão Chung
周宇=Chu Vũ
蔡和森=Thái Hoà Sâm
紫茗=Tử Mính
杨紫茗=Dương Tử Mính
安娇=An Kiều
陶晋安=Đào Tấn An
于珍=Vu Trân
杜文奎=Đỗ Văn Khuê
1号=Số 1
方柏潇=Phương Bách Tiêu
杨志恒=Dương Chí Hằng
卓言=Trác Ngôn
宋子淮=Tống Tử Hoài
薛川=Tiết Xuyên
于队长=Vu đội trưởng
刘伟松=Lưu Vĩ Tùng
田辉勤=Điền Huy Cần
松岩=Tùng Nham
潘松岩=Phan Tùng Nham
陈家主=Trần gia chủ
陈晓壮=Trần Hiểu Tráng
风连城=Phong Liên Thành
阿跳=A Khiêu
熊兆坤=Hùng Triệu Khôn
庚金=Canh Kim
李文友=Lý văn hữu
陈晓军=Trần Hiểu Quân
钟文友=Chung văn hữu
陈闻=Trần Văn
姜秋以=Khương Thu Dĩ
路雨=Lộ Vũ
叶培昌=Diệp Bồi Xương
蔡叔父=Thái thúc phụ
蔡同尘=Thái Đồng Trần
王喜贵=Vương Hỉ Quý
周勇=Chu Dũng
马大婶=Mã đại thẩm
蔡知县=Thái tri huyện
李师爷=Lý sư gia
陈平=Trần Bình
平叔=Bình thúc
小环=tiểu Hoàn
宋理忠=Tống Lý Trung
洛少爷=Lạc thiếu gia
小洛=tiểu Lạc
夏娜=Hạ Na
尹韵=Doãn Vận
陈萱=Trần Huyên
谢文晋=Tạ Văn Tấn
李国昌=Lý Quốc Xương
陈朔威=Trần Sóc Uy
大山=Đại Sơn
谢筇=Tạ Cung
田凤琴=Điền Phượng Cầm
陈红雷=Trần Hồng Lôi
陈凯歌=Trần Khải Ca
小婉=Tiểu Uyển
卡娅=Kaya
石明水=Thạch Minh Thuỷ
李菲=Lý Phỉ
王自东=Vương Tự Đông
斯威兰=Swaziland
阎达石=Diêm Đạt Thạch
姚文=Diêu Văn
张明山=Trương Minh Sơn
张嘉嘉=Trương Gia Gia
龚玉宝=Cung Ngọc Bảo
明子=Akiko
贾明山=Giả Minh Sơn
王浩平=Vương Hạo Bình
高友根=Cao Hữu Căn
西毒=Tây Độc
穆灵=Mục Linh
张倩=Trương Thiến
唐雄=Đường Hùng
唐凤=Đường Phượng
金明洙=Kim Myung-soo
张继业=Trương Kế Nghiệp
小莹=tiểu Oánh
小瑛=tiểu Anh
齐淑云=Tề Thục Vân
纪文章=Kỷ Văn Chương
张雪松=Trương Tuyết Tùng
高震=Cao Chấn
贺克强=Hạ Khắc Cường
杨冠山=Dương Quan Sơn
文廷=Văn Đình
魏莹=Nguỵ Oánh
魏瑛=Nguỵ Anh
郑宏基=Trịnh Hoành Cơ
沈瑞=Thẩm Thuỵ
吴向臣=Ngô Hướng Thần
路平=Lộ Bình
秦阳=Tần Dương
魏明辉=Nguỵ Minh Huy
苗小英=Miêu Tiểu Anh
李杰=Lý Kiệt
韩辉=Hàn Huy
冯定一=Phùng Định Nhất
赵凡=Triệu Phàm
王前进=Vương Tiền Tiến
高小梅=Cao Tiểu Mai
尤文=Vưu Văn
于翠敏=Vu Thuý Mẫn
王前=Vương Tiền
牛世伟=Ngưu Thế Vĩ
刘金堂=Lưu Kim Đường
张楠=Trương Nam
谢文武=Tạ Văn Võ
魏丽丽=Nguỵ Lệ Lệ
罗劲松=La Kính Tùng
岳敏=Nhạc Mẫn
竹熙阳=Trúc Hy Dương
吴婷=Ngô Đình
宁馨=Ninh Hinh
陆小花=Lục Tiểu Hoa
黄俐=Hoàng Lỵ
小逸=tiểu Dật
丁慧=Đinh Tuệ
羊茂=Dương Mậu
刘玲=Lưu Linh
方蓓=Phương Bội
舒婉=Thư Uyển
东流=Đông Lưu
冯刚=Phùng Cương
卢国民=Lư Quốc Dân
马景瑞=Mã Cảnh Thuỵ
陈洛=Trần Lạc
郑秀=Trịnh Tú
于队=Vu đội
蔡明福=Thái Minh Phúc
莫无洛=Mạc Vô Lạc
林水瑶=Lâm Thuỷ Dao
周文行=Chu Văn Hành
周文=Chu Văn
绍炳=Thiệu Bính
张贺=Trương Hạ
彭竞英=Bành Cạnh Anh
蒋勋=Tưởng Huân
蒋小勇=Tưởng Tiểu Dũng
张勇=Trương Dũng
刘冕=Lưu Miện
张茗=Trương Mính
春珍=Xuân Trân
佳佳=Giai Giai
高向森=Cao Hướng Sâm
李玉芬=Lý Ngọc Phân
周文海=Chu Văn Hải
周大山=Chu Đại Sơn
周慧慧=Chu Tuệ Tuệ
张媛=Trương Viện
赵姗=Triệu San
波涛=Ba Đào
王璂=Vương Ky
李鸿顺=Lý Hồng Thuận
邹燕=Trâu Yến
许康=Hứa Khang
刘晨=Lưu Thần
金明哲=Kim Minh Triết
莉莉=Lỵ Lỵ
刘蕾=Lưu Lôi
姚佳佳=Diêu Giai Giai
潘玉成=Phan Ngọc Thành
张慧=Trương Tuệ
张慧正=Trương Tuệ Chính
程明亮=Trình Minh Lượng
晓天=Hiểu Thiên
朱国山=Chu Quốc Sơn
高舜钦=Cao Thuấn Khâm
吴晓天=Ngô Hiểu Thiên
澳洲老爷=ông lớn châu Úc
高老爷=ông lớn Cao
谢路平=Tạ Lộ Bình
小瑞=tiểu Thuỵ
刘作栋=Lưu Tác Đống
傅杰全=Phó Kiệt Toàn
董浩=Đổng Hạo
童淼=Đồng Miểu
刘和=Lưu Hoà
时袅仁=Thì Niểu Nhân
李冬=Lý Đông
叶祖德=Diệp Tổ Đức
尹家升=Doãn Gia Thăng
林佩佩=Lâm Bội Bội
赵汉初=Triệu Hán Sơ
小唐宁=Tiểu Đường Ninh
王培荣=Vương Bồi Vinh
贾明远=Giả Minh Viễn
邓翠萍=Đặng Thuý Bình
何爵士=Hà Tước Sĩ
陈敏敏=Trần Mẫn Mẫn
叶继祖=Diệp Kế Tổ
陈万英=Trần Vạn Anh
周禹锡=Chu Vũ Tích
邱跃进=Khâu Dược Tiến
邱跃=Khâu Dược
唐宁=Đường Ninh
赵吉成=Triệu Cát Thành
安小婉=An Tiểu Uyển
王仕尧=Vương Sĩ Nghiêu
李财=Lý Tài
徐立民=Từ Lập Dân
林震廷=Lâm Chấn Đình
杨大和=Dương Đại Hoà
邓子杰=Đặng Tử Kiệt
杨忠=Dương Trung
金翠玲=Kim Thuý Linh
邹鸿=Trâu Hồng
楚君=Sở quân
朱东=Chu Đông
公车上书=Công Xa thượng thư
丁颜=Đinh Nhan
守一=Thủ Nhất
伟民=Vĩ Dân
杜晓忠=Đỗ Hiểu Trung
王慧洁=Vương Tuệ Khiết
田岱利=Điền Đại Lợi
李浩天=Lý Hạo Thiên
郭斌=Quách Bân
段承忠=Đoạn Thừa Trung
张汉宁=Trương Hán Ninh
立国=Lập Quốc
王立国=Vương Lập Quốc
萧天水=Tiêu Thiên Thuỷ
程小山=Trình Tiểu Sơn
小唐逸=Tiểu Đường Dật
刘若明=Lưu Nhược Minh
米雪=Mễ Tuyết
高明明=Cao Minh Minh
李祥=Lý Tường
胡晓莉=Hồ Hiểu Lỵ
秦龙=Tần Long
纪乐东=Kỷ Nhạc Đông
殷守发=Ân Thủ Phát
项荣=Hạng Vinh
赵敬忠=Triệu Kính Trung
成业=Thành Nghiệp
焦军=Tiêu Quân
孔来恩=Khổng Lai Ân
聂东=Niếp Đông
贾汉森=Giả Hán Sâm
庞立文=Bàng Lập Văn
小娴=tiểu Nhàn
马继业=Mã Kế Nghiệp
迪迪=Địch Địch
周伟伟=Chu Vĩ Vĩ
廖锦添=Liệu Cẩm Thiêm
赵迪=Triệu Địch
赵发=Triệu Phát
周倩倩=Chu Thiến Thiến
赵云雷=Triệu Vân Lôi
乔宝林=Kiều Bảo Lâm
王仁邦=Vương Nhân Bang
刘纯纯=Lưu Thuần Thuần
张长生=Trương Trường Sinh
李木奇=Lý Mộc Kỳ
孟艳艳=Mạnh Diễm Diễm
常伟=Thường Vĩ
王丹=Vương Đan
陈明涛=Trần Minh Đào
林鸣=Lâm Minh
郭文天=Quách Văn Thiên
紫晴=Tử Tình
卞军=Biện Quân
塔拉克=Talaq
劳伦佐·丹=Lorenzo · Dan
劳伦佐=Lorenzo
何如宾=Hà Như Tân
吕凯=Lã Khải
高婕=Cao Tiệp
张守=Trương Thủ
陈慕林=Trần Mộ Lâm
朝伦=Triều Luân
冯哲=Phùng Triết
小芸=Tiểu Vân
真理之眼=Con Mắt Chân Lý
扎克拉=Trát Khắc Lạp
秀娥=Tú Nga
程世虎=Trình Thế Hổ
程世=Trình Thế
冯延=Phùng Diên
高全友=Cao Toàn Hữu
王喜=Vương Hỉ
朱婷婷=Chu Đình Đình
婷婷=Đình Đình
林家伟=Lâm Gia Vĩ
作龙=Tác Long
柳若鸿=Liễu Nhược Hồng
陈波涛=Trần Ba Đào
程朝伦=Trình Triều Luân
李铁=Lý Thiết
张志伟=Trương Chí Vĩ
刘兆坤=Lưu Triệu Khôn
丁瑞国=Đinh Thuỵ Quốc
周海军=Chu Hải Quân
陈婉君=Trần Uyển Quân
苏静娴=Tô Tĩnh Nhàn
杨晓顺=Dương Hiểu Thuận
赵继成=Triệu Kế Thành
关荷=Quan Hà
陈明涵=Trần Minh Hàm
穆平=Mục Bình
苏海涛=Tô Hải Đào
苏成文=Tô Thành Văn
蒋鼎=Tưởng Đỉnh
谢文廷=Tạ Văn Đình
乔芙蓉=Kiều Phù Dung
杨顺军=Dương Thuận Quân
田野=Điền Dã
雷鸣=Lôi Minh
晓楼=Hiểu Lâu
刘晓楼=Lưu Hiểu Lâu
王培仁=Vương Bồi Nhân
李全=Lý Toàn
晚晴=Vãn Tình
张培明=Trương Bồi Minh
于怀远=Vu Hoài Viễn
呼景山=Hô Cảnh Sơn
白川织锦=Shirakawa Ori
一色羽织锦=Isshiki Ori
孙玉平=Tôn Ngọc Bình
沈言新=Thẩm Ngôn Tân
丽莎=Lisa
泰格=Tiger
老幽=Lão U
张邦国=Trương Bang Quốc
云姨=Vân di
张强军=Trương Cường Quân
眉眉=Mi Mi
李相诛=Lý Tương Tru
廖静=Liêu Tĩnh
宁凝=Ninh Ngưng
贾猛=Giả Mãnh
贾强=Giả Cường
李革=Lý Cách
贾宝旺=Giả Bảo Vượng
韩冬梅=Hàn Đông Mai
董玉萍=Đổng Ngọc Bình
李善才=Lý Thiện Tài
黄绍雄=Hoàng Thiệu Hùng
姚立柱=Diêu Lập Trụ
范进=Phạm Tiến
秦博仁=Tần Bác Nhân
刘小辉=Lưu Tiểu Huy
卓宝儿=Trác Bảo Nhi
沈喜云=Thẩm Hỉ Vân
曹兴信=Tào Hưng Tín
黄允旭=Hoàng Doãn Húc
邵梁=Thiệu Lương
慕迟=Mộ Trì
楚格=Sở Cách
若若=Nhược Nhược
高鹏飞=Cao Bằng Phi
汪军=Uông Quân
于亮=Vu Lượng
胡小秋=Hồ Tiểu Thu
阚丽丽=Hám Lệ Lệ
何平=Hà Bình
金日晶=Kim Il-jung
江日进=Giang Nhật Tiến
江日=Giang Nhật
常斌=Thường Bân
郝明辉=Hác Minh Huy
曾倩=Tằng Thiến
王晖=Vương Huy
郭博文=Quách Bác Văn
文凯=Văn Khải
王晓军=Vương Hiểu Quân
纪昌国=Kỷ Xương Quốc
李虹=Lý Hồng
赵壮=Triệu Tráng
郭放=Quách Phóng
立人=Lập Nhân
高金伟=Cao Kim Vĩ
胡静=Hồ Tĩnh
小纯=Tiểu Thuần
小宝=Tiểu Bảo
方舟=Phương Chu
刘兵=Lưu Binh
王毅=Vương Nghị
肖强=Tiêu Cường
王妍=Vương Nghiên
吴天运=Ngô Thiên Vận
王超=Vương Siêu
刘保存=Lưu Bảo Tồn
荣华=Vinh Hoa
贺军=Hạ Quân
周学森=Chu Học Sâm
蔡国平=Thái Quốc Bình
奥伦多=Orlando
塞弗罗萨=Sefolosha
张伟武=Trương Vĩ Võ
谢美芳=Tạ Mỹ Phương
田春=Điền Xuân
郭洪文=Quách Hồng Văn
王建梅=Vương Kiến Mai
刘琨=Lưu Côn
维纶=Duy Luân
张风=Trương Phong
李跃文=Lý Dược Văn
孙岩农=Tôn Nham Nông
于方舟=Vu Phương Chu
马璐璐=Mã Lộ Lộ
珊珊=San San
孟晓丽=Mạnh Hiểu Lệ
王素兰=Vương Tố Lan
李秀伟=Lý Tú Vĩ
陆波涛=Lục Ba Đào
林喜=Lâm Hỉ
李建林=Lý Kiến Lâm
安迪=Andy
姜北柠=Khương Bắc Nịnh
童彤=Đồng Đồng
孙杰=Tôn Kiệt
乔强军=Kiều Cường Quân
日伦=Nhật Luân
刘琦=Lưu Kỳ
韩姐姐=Hàn tỷ tỷ
李教授=Lý giáo sư
楚文=Sở Văn Tài
小楚=tiểu Sở
楚老师=Sở lão sư
陈琳琳=Trần Lâm Lâm
小黎=tiểu Lê
秦泽泽=Tần Trạch
张小娴=Trương Tiểu Nhàn
苏韵锦=Tô Vận Cẩm
苏老师=Tô lão sư
楚同学=Sở đồng học
陈哥=Trần ca
陈锋=Trần Phong
陈峰=Trần Phong
陆铭=Lục Minh
王林=Vương Lâm
李在理=Lý Tại Lý
韩冰=Hàn Băng
文才=Văn Tài
公孙渐离=Công Tôn Tiệm Li
李卫红=Lý Vệ Hồng
赵建国=Triệu Kiến Quốc
林芬=Lâm Phân
吕臻=Lã Trăn
定中=Định Trung
刘铭=Lưu Minh
刘斌=Lưu Bân
秦成仁=Tần Thành Nhân
楚文才=Sở Văn Tài
吴黎=Ngô Lê
孔亮=Khổng Lượng
高益民=Cao Ích Dân
王文卓=Vương Văn Trác
孙少团=Tôn Thiếu Đoàn
张春燕=Trương Xuân Yến
娇娇=Kiều Kiều
徐维纶=Từ Duy Luân
刘青=Lưu Thanh
马罗塔=Marotta
贾跃军=Giả Dược Quân
佯做=Dương Tố
邵刚=Thiệu Cương
李文长=Lý Văn Trường
杨越=Dương Việt
小越=tiểu Việt
初桐=Sơ Đồng
雅月=Nhã Nguyệt
李初桐=Lý Sơ Đồng
小琼=Tiểu Quỳnh
陆柯=Lục Kha
玄成=Hyun-sung
李玄成=Lee Hyun-sung
金一泰=Kim Il-tae
贞淑=Jung-sook
金玄成=Kim Hyun-sung
陆先生=Lục tiên sinh
赵成=Triệu Thành
世博园=Thế Bác Viên
张春梅=Trương Xuân Mai
李万天=Lý Vạn Thiên
李晓东=Lý Hiểu Đông
李局长=Lý trưởng phòng
安林英=An Lâm Anh
戴惠来=Đái Huệ Lai
刘双江=Lưu Song Giang
范立人=Phạm Lập Nhân
蔡明=Thái Minh
苏超群=Tô Siêu Quần
周峰=Chu Phong
段鹏=Đoạn Bằng
段贺军=Đoạn Hạ Quân
有望=Hữu Vọng
孙有望=Tôn Hữu Vọng
肖小慧=Tiêu Tiểu Tuệ
杨志奇=Dương Chí Kỳ
姚军=Diêu Quân
祁丽娜=Kỳ Lệ Na
恩鸿=Ân Hồng
冯日伦=Phùng Nhật Luân
马杰=Mã Kiệt
刘益望=Lưu Ích Vọng
李良=Lý Lương
吴凤娟=Ngô Phượng Quyên
孙景超=Tôn Cảnh Siêu
李萌=Lý Manh
曾建国=Tằng Kiến Quốc
小曾=Tiểu Tằng
蒙巴=Mumbwa
李普=Lý Phổ
萨卡=Saka
菲普斯=Phipps
王标=Vương Tiêu
朱红梅=Chu Hồng Mai
敬群=Kính Quần
敖渊=Ngao Uyên
曾亮=Tằng Lượng
曾司令=Tằng tư lệnh
曾继伦=Tằng Kế Luân
南落=Nam Lạc
王露=Vương Lộ
藏风=Tàng Phong
爱军=Ái Quân
马有福=Mã Hữu Phúc
陆一波=Lục Nhất Ba
一波=Nhất Ba
李爱军=Lý Ái Quân
邓文秩=Đặng Văn Trật
千首=Thiên Thủ
千首大王=Thiên Thủ đại vương
金鹏=Kim Bằng
芝兰=Chi Lan
通天=Thông Thiên
元始=Nguyên Thuỷ
小秦=Tiểu Tần
赵恩鸿=Triệu Ân Hồng
钱有智=Tiền Hữu Trí
王丽珍=Vương Lệ Trân
李霄汉=Lý Tiêu Hán
张强=Trương Cường
张定中=Trương Định Trung
周文凯=Chu Văn Khải
黄向东=Hoàng Hướng Đông
林卫国=Lâm Vệ Quốc
曾庆明=Tằng Khánh Minh
崔敬群=Thôi Kính Quần
通玄=Thông Huyền
朱峰=Chu Phong
小丁=Tiểu Đinh
金鹏太子=Kim Bằng thái tử
羊力大仙=Dương Lực đại tiên
李维=Lý Duy
刘凤鸣=Lưu Phượng Minh
岛田=Shimada
成汤=Thành Thang
继母巫后=mẹ kế Vu Hậu
叶文武=Diệp Văn Võ
小璐=Tiểu Lộ
林深河=Lâm Thâm Hà
小龙=Tiểu Long
程玉林=Trình Ngọc Lâm
朱宗元=Chu Tông Nguyên
思高=Tư Cao
高秀才=tú tài Cao
高玄=Cao Huyền
展首长=thủ trưởng Triển
林汉龙=Lâm Hán Long
程亮=Trình Lượng
岳林伟=Nhạc Lâm Vĩ
贺民=Hạ Dân
柳广文=Liễu Quảng Văn
龙红军=Long Hồng Quân
曹秀娥=Tào Tú Nga
吴征=Ngô Chinh
孟江=Mạnh Giang
小思=Tiểu Tư
赵万天=Triệu Vạn Thiên
素萍=Tố Bình
江雅=Giang Nhã
伊蕾=Y Lôi
林伊蕾=Lâm Y Lôi
张成忠=Trương Thành Trung
谢雨田=Tạ Vũ Điền
张素萍=Trương Tố Bình
刘铮=Lưu Tranh
程建全=Trình Kiến Toàn
宋昌国=Tống Xương Quốc
梁昱=Lương Dục
大成=Đại Thành
顾大成=Cố Đại Thành
露露=Lộ Lộ
叶小璐=Diệp Tiểu Lộ
小亚衣酱=Ami-chan
蔡司=Thái Ty
李守一=Lý Thủ Nhất
高大年=Cao Đại Niên
吴小菊=Ngô Tiểu Cúc
裕太=Yuuta
小惠=Megumi-chan
礼京=Rei
杏子=Kyoko
何森=Hà Sâm
萧若若=Tiêu Nhược Nhược
何磊=Hà Lỗi
贾汉山=Giả Hán Sơn
白川雪奈=Shirakawa Yukina
李刚=Lý Cương
小雪奈=Yukina-chan
赵国轩=Triệu Quốc Hiên
刘建林=Lưu Kiến Lâm
胡小玲=Hồ Tiểu Linh
小东=Tiểu Đông
小玉=Tiểu Ngọc
岳培敏=Nhạc Bồi Mẫn
张继泽=Trương Kế Trạch
刘进=Lưu Tiến
杜文琪=Đỗ Văn Kỳ
马元杰=Mã Nguyên Kiệt
王振清=Vương Chấn Thanh
周海兰=Chu Hải Lan
李会彬=Lý Hội Bân
谢忠明=Tạ Trung Minh
威尔斯=Wells
怀志=Hoài Chí
明明=Minh Minh
卢明明=Lô Minh Minh
包怀志=Bao Hoài Chí
鹰九=Ưng Cửu
普渡禅师=Phổ Độ thiền sư
杨燕=Dương Yến
姗姗=San San
林姗姗=Lâm San San
古小蕾=Cổ Tiểu Lôi
亮太=Ryōta
亚衣=Ami
智也=Tomoya
山野=Yamano
管沪生=Quản Hỗ Sinh
管平=Quản Bình
孟凡林=Mạnh Phàm Lâm
森林=Sâm Lâm
爱酱=Ai-chan
金刚狼=Wolverine
斋藤源=Saitō Shin
抚子=Nadeshiko
优纪=Yuuki
良平=Ryohei
平人=Heito
礼奈=Ayana
钱爱国=Tiền Ái Quốc
美惠子=Mieko
刘伟=Lưu Vĩ
王强=Vương Cường
马洪力=Mã Hồng Lực
刘启光=Lưu Khải Quang
林丹丹=Lâm Đan Đan
莲太郎=Rentarou
刘跃=Lưu Dược
高燕秋=Cao Yến Thu
杜一来=Đỗ Nhất Lai
高汉生=Cao Hán Sinh
赵萍=Triệu Bình
周东=Chu Đông
千代=Chiyo
凤南=Takano
孟国强=Mạnh Quốc Cường
井上=Inoue
洞悉之瞳=Con Mắt Thông Thái
李涛=Lý Đào
结城爱=Yuuki Ai
凤君=Taka-kun
中野=Nakano
丁国山=Đinh Quốc Sơn
李云贵=Lý Vân Quý
幸田=Kota
幸子=Sachiko
贝蒂=Betty
威娜=Wina
雪妮=Sydney
苏瓦鞑剌=Suvarta
晓梅=Hiểu Mai
胡克=Hooke
飞云=Phi Vân
钱水=Tiền Thuỷ
村田=Murata
山下=Yamashita
阿汤哥=Tom Cruise
钱首长=thủ trưởng Tiền
林汊隆=Lâm Xá Long
束李荃=Thúc Lý Thuyên
悠马=Yuuma
文同=Văn Đồng
凉介=Ryosuke
小丽=Tiểu Lệ
林首长=Lâm thủ trưởng
冉妖=Nhiễm Yêu
蔡生杰=Thái Sinh Kiệt
蔡大=Thái Đại
蔡三十=Thái Tam Thập
蔡俊杰=Thái Tuấn Kiệt
钟委员=uỷ viên Chung
陈思根=Trần Tư Căn
萧白朗=Tiêu Bạch Lãng
崔云红=Thôi Vân Hồng
林汉隆=Lâm Hán Long
张思雅=Trương Tư Nhã
大丫=Đại Nha
伍子衿=Ngũ Tử Khâm
俊杰=Tuấn Kiệt
慎太=Shin
钟利时=Chung Lợi Thì
蕾蕾=Lôi Lôi
苏浩杰=Tô Hạo Kiệt
王志奇=Vương Chí Kỳ
李蕾蕾=Lý Lôi Lôi
郝存仁=Hác Tồn Nhân
江顺=Giang Thuận
士达=Sĩ Đạt
刘小英=Lưu Tiểu Anh
刘平=Lưu Bình
玉河=Ngọc Hà
小郑=Tiểu Trịnh
林正洋=Lâm Chính Dương
林峰=Lâm Phong
春奈酱=Haruna-chan
春奈=Haruna
白予=Bạch Dư
山崎桑=Yamasaki-san
山崎前辈=Yamasaki-senpai
花沢=Hana
莎朗=Sharon
亚尔曼=Yalman
大户久保=Daho Kubo
亚美=Yami
礼香=Rika
梁明超=Lương Minh Siêu
楚楚=Sở Sở
傅家骏=Phó Gia Tuấn
冰水仙=Băng Thuỷ Tiên
李汉伟=Lý Hán Vĩ
午木=Ngọ Mộc
魏爱文=Nguỵ Ái Văn
奎托斯=Kratos
李炎=Lý Viêm
周克岩=Chu Khắc Nham
朱利安=Julian
黄磊=Hoàng Lỗi
谷祥恩=Cốc Tường Ân
高志杰=Cao Chí Kiệt
王新民=Vương Tân Dân
周立成=Chu Lập Thành
薛子良=Tiết Tử Lương
李迪=Lý Địch
张大义=Trương Đại Nghĩa
黄安德=Hoàng An Đức
艾儒略=Ngải Nho Lược
张赓=Trương Canh
刘大勇=Lưu Đại Dũng
陆春恩=Lục Xuân Ân
周亮=Chu Lượng
郭红军=Quách Hồng Quân
邱晓梅=Khâu Hiểu Mai
罗静雯=La Tĩnh Văn
李松=Lý Tùng
图佳=Đồ Giai
孙森林=Tôn Sâm Lâm
刘占忠=Lưu Chiếm Trung
周红军=Chu Hồng Quân
伍恒=Ngũ Hằng
杨振兴=Dương Chấn Hưng
小钢炮=Tiểu Cương Pháo
大志=Đại Chí
金世光=Kim Thế Quang
卢植三=Lô Thực Tam
马大宝=Mã Đại Bảo
欢欢=Hoan Hoan
赵江=Triệu Giang
谭君荣=Đàm Quân Vinh
唐欣=Đường Hân
王小光=Vương Tiểu Quang
牛大成=Ngưu Đại Thành
黄敬业=Hoàng Kính Nghiệp
黄敬仁=Hoàng Kính Nhân
陈少杰=Trần Thiếu Kiệt
郑立国=Trịnh Lập Quốc
安妮丝=Annys
吉维特=Givet
玛索=Marceau
米莉亚=Milia
奥西克丽丝=Osikris
汪明涵=Uông Minh Hàm
王启明=Vương Khải Minh
赫尔斯=Hách Nhĩ Tư
郭江=Quách Giang
赵伟民=Triệu Vĩ Dân
连红军=Liên Hồng Quân
舒婕=Thư Tiệp
黄凯=Hoàng Khải
亡灵巫师阁下=vong linh vu sư các hạ
金大德=Kim Đại Đức
曹国忠=Tào Quốc Trung
美穂=Miho
童真毕业许可证=giấy phép mất zin
明日川=Hiaki
李维斯=Reeves
伊所尔达王=Eesalda Vương
宁10=Ninh 10
徐长卿=Từ Trường Khanh
张定昌=Trương Định Xương
定昌=Định Xương
奥菲尼=Fenny
李博=Lý Bác
黄杰=Hoàng Kiệt
静静=Tĩnh Tĩnh
周士儒=Chu Sĩ Nho
周光辉=Chu Quang Huy
邱四儿=Khâu Tứ Nhi
温体仁=Ôn Thể Nhân
周延儒=Chu Diên Nho
张采=Trương Thải
张溥=Trương Phổ
张好古=Trương Hảo Cổ
陈青云=Trần Thanh Vân
还珠楼主=Hoàn Châu Lâu Chủ
梁羽生=Lương Vũ Sinh
方国珍=Phương Quốc Trân
陈友谅=Trần Hữu Lượng
周dong天=Chu Dong Thiên
方相公=Phương tương công
马涛=Mã Đào
王洛宾=Vương Lạc Tân
奉华=Phụng Hoa
郭士达=Quách Sĩ Đạt
方以智=Phương Dĩ Trí
茂林=Mậu Lâm
何亚坤=Hà Á Khôn
李贵成=Lý Quý Thành
文怀=Văn Hoài
孙淳=Tôn Thuần
郭逸=Quách Dật
陶庵=Đào Am
博西勒=Bác Tây Lặc
乔莉莉=Kiều Lị Lị
顾喜武=Cố Hỉ Võ
田庆斌=Điền Khánh Bân
廖昌盛=Liêu Hưng Thịnh
齐亚男=Tề Á Nam
小霞=Tiểu Hà
李磊=Lý Lỗi
杨记=Dương Ký
马托=Mã Thác
海山=Hải Sơn
杨大海=Dương Đại Hải
一鸣=Nhất Minh
刘存=Lưu Tồn
阚国立=Hám Quốc Lập
裴长涵=Bùi Trường Hàm
顾晓茹=Cố Hiểu Nhự
孙磊=Tôn Lỗi
彭占山=Bành Chiếm Sơn
张岱=Trương Đại
常师德=Thường Sư Đức
梅晚=Mai Vãn
周洞天=Chu Động Thiên
梅老爷=Mai ông lớn
媚颜儿=Mị Nhan Nhi
眉娘=Mi Nương
蔡实=Thái Thực
柏杨=Bách Dương
芝香=Chi Hương
卓大勇=Trác Đại Dũng
朱鸣夏=Chu Minh Hạ
蒋估中=Tưởng Cổ Trung
肖照川=Tiêu Chiếu Xuyên
老付=Lão Phó
郭宏宇=Quách Hoành Vũ
孙玉河=Tôn Ngọc Hà
孙玉江=Tôn Ngọc Giang
袁志光=Viên Chí Quang
任凤霞=Nhậm Phượng Hà
芳革地=Fanggedi
桥田至=Hashida Itaru
郑尚洁=Trịnh Thượng Khiết
袁子光=Viên Tử Quang
谢澎=Tạ Bành
莫笑安=Mạc Tiếu An
洪部长=bộ trưởng Hồng
何振峰=Hà Chấn Phong
金成=Kim Thành
谢参谋=tham mưu Tạ
郁德=Úc Đức
谈澍=Đàm Chú
洪璜楠=Hồng Hoàng Nam
小五=Tiểu Ngũ
陈海阳=Trần Hải Dương
都德=Đô Đức
何鸣=Hà Minh
刘香=Lưu Hương
施奈德=Thi Nại Đức
施上尉=thượng uý Thi
施耐德=Schneider
薄呢=vải tuýt
李锦龙=Lý Cẩm Long
施十四=Thi Mười Bốn
李雷=Lý Lôi
曾怀民=Tằng Hoài Dân
江浩然=Giang Hạo Nhiên
李博远=Lý Bác Viễn
顾占东=Cố Chiếm Đông
铁石=Thiết Thạch
刘铁=Lưu Thiết
商国民=Thương Quốc Dân
毛海山=Mao Hải Sơn
赵青天=Triệu Thanh Thiên
程晓红=Trình Hiểu Hồng
江浩=Giang Hạo
任铁石=Nhậm Thiết Thạch
毛志炜=Mao Chí Vĩ
李金蓉=Lý Kim Dung
刘云=Lưu Vân
忻明=Hãn Minh
许昌鸿=Hứa Xương Hồng
陈国涛=Trần Quốc Đào
林博文=Lâm Bác Văn
库赛=Cousse
程昆=Trình Côn
高建飞=Cao Kiến Phi
白燕=Bạch Yến
钱一鸣=Tiền Nhất Minh
吕广义=Lã Quảng Nghĩa
李青莲=Lý Thanh Liên
郑则培=Trịnh Tắc Bồi
光武=Gwangmu
允儿=Yoon-ah
朴允儿=Park Yoon-ah
李光武=Lee Gwangmu
刘刚=Lưu Cương
陈秋菊=Trần Thu Cúc
金向阳=Kim Hướng Dương
谭笑天=Đàm Tiếu Thiên
陶矶=Đào Ki
素言=Tố Ngôn
黄琳=Hoàng Lâm
林国柱=Lâm Quốc Trụ
高天=Cao Thiên
吴刚=Ngô Cương
齐茂林=Tề Mậu Lâm
王小凤=Vương Tiểu Phượng
孙向前=Tôn Hướng Tiền
古忻明=Cổ Hãn Minh
高会新=Cao Hội Tân
石志奇=Thạch Chí Kỳ
包衡=Bao Hoành
李成柱=Lý Thành Trụ
刘建国=Lưu Kiến Quốc
沈广文=Quảng Văn Thẩm
杜博亚=Đỗ Bác Á
刘颖=Lưu Dĩnh
李天华=Lý Thiên Hoa
叶思曼=Diệp Tư Mạn
田卫兵=Điền Vệ Binh
高小兰=Cao Tiểu Lan
张震=Trương Chấn
查米安=Charmian
伊所尔达=Eesalda
周建国=Chu Kiến Quốc
李亨通=Lý Hanh Thông
贝利夫=Belief
黄贞=Hoàng Trinh
张广湉=Trương Quảng Điềm
依偌丝=Yiluosi
熊三拔=Hùng Tam Bạt
郭居静=Quách Cư Tĩnh
柳如是=Liễu Như Thị
乌开地=Ô Khai Địa
杨公=Dương Công
王德化=Vương Đức Hóa
毛三生=Mao Tam Sinh
徐骥=Từ Ký
杨廷筠=Dương Đình Quân
李之藻=Lý Chi Tảo
集英=Tập Anh
雅轩=Nhã Hiên
张士诚=Trương Sĩ Thành
赵若=Triệu Nhược
孙旺才=Tôn Vượng Tài
苏梅=Tô Mai
安妮斯=Annys
蔡静娟=Thái Tĩnh Quyên
杜元老=nguyên lão Đỗ
特洛夫=Triff
余知府=Dư tri phủ
余太守=Dư thái thú
小七=Tiểu Thất
桑普拉斯=Sampras
莉丽斯=Lilith
特里夫=Triff
周采=Chu Thải
周剥皮=Chu lột da
赵引弓=Triệu Dẫn Cung
云笈观=Vân Cấp Quan
王慧娟=Vương Tuệ Quyên
陆小天=Lục Tiểu Thiên
金神父=cha xứ Kim
盗泉子=Đạo Tuyền Tử
薛若望=Tiết Nhược Vọng
司凯=Ty Khải
洪水尹=Hồng Thuỷ Doãn
平户=Hirado
田毅=Điền Nghị
纳茨=Natz
骆家辉=Lạc Gia Huy
玛格德堡=Magdeburg
侯富贵=Hầu Phú Quý
迪伦=Dylan
奥伦=Erlen
周怡情=Chu Di Tình
孙浩=Tôn Hạo
翻天保=Phiên Thiên Bảo
王湛生=Vương Trạm Sinh
马小凤=Mã Tiểu Phượng
石海川=Thạch Hải Xuyên
胡兰=Hồ Lan
张竞峰=Trương Cạnh Phong
小武=Tiểu Võ
樱铃=Anh Linh
路易七世=Louis Đệ Thất
路易六世=Louis Đệ Lục
刘新=Lưu Tân
路菲尔德=Ludwig
路易=Louis
翻海保=Phiên Hải Bảo
孔祥恩=Khổng Tường Ân
吕放=Lã Phóng
王涛=Vương Đào
林向南=Lâm Hướng Nam
马明宇=Mã Minh Vũ
秦成业=Tần Thành Nghiệp
马素贞=Mã Tố Trinh
周克强=Chu Khắc Cường
宁志远=Ninh Chí Viễn
宁德诚=Ninh Đức Thành
宁德忠=Ninh Đức Trung
王泰成=Vương Thái Thành
申胡=Thân Hồ
游隆=Du Long
游海=Du Hải
商文武=Thương Văn Võ
红日=Hồng Nhật
张芳=Trương Phương
赵雅月=Triệu Nhã Nguyệt
张瑞国=Trương Quốc Thuỵ
黄伟=Hoàng Vĩ
徐军=Từ Quân
郭涛=Quách Đào
袁有才=Viên Hữu Tài
王凤起=Vương Phượng Khởi
高于真=Cao Vu Chân
七海真美=Nanami Mami
奈奈子=Nanako
焦作龙=Tiêu Tác Long
钱伯斯=Chambers
桑迪·勒纳=Sandy Lerner
裘小艺=Cừu Tiểu Nghệ
刘飞=Lưu Phi
黛尔菲尼娅=Delfinia
斯蒂亚=Sedia
巫后=Vu Hậu
陆易=Louis
御子姐=Miko tỷ
京都之主=Kyoto no Arushi
林越=Lâm Việt
罗教授=La giáo sư
杨宏斌=Dương Hoành Bân
林海风=Lâm Hải Phong
顾铁柱=Cố Thiết Trụ
顾玉成=Cố Ngọc Thành
小丫=Tiểu Nha
禹作敏=Vũ Tác Mẫn
薛河=Tiết Hà
罗法琦=La Pháp Kỳ
曹总工=Tào tổng công
登火计划=kế hoạch Đăng Hỏa
苟文=Cẩu Văn
天问=Thiên Vấn
雷浩=Lôi Hạo
顾爷爷=Cố gia gia
金乌号=No. Kim Ô
火神号=No. Hỏa Thần
杨正=Dương Chính
罗休=La Hưu
曹国蔺=Tào Quốc Lận
祝融号=No. Chúc Dung
冰冰=Băng Băng
张朝晖=Trương Triều Huy
小花=Tiểu Hoa
二柱子=Nhị Trụ Tử
连俏=Liên Tiếu
杜小雅=Đỗ Tiểu Nhã
宋晴=Tống Tình Y
盖亚=Gaia
月池薰=Tsukiike Kaori
雅洁=Nhã Khiết
宝儿=Bảo Nhi
杨雅洁=Dương Nhã Khiết
忻怡=Hân Di
大周=Đại Chu
军子=Quân Tử
玛丽莲=Marilyn
块地皮=mảnh đất thổ cư
妮卡尔=Necar
亚兹丹=Yazdan
萨拉=Sara
兔狲=Pallas
栓子=Xuyên Tử
叶妈妈=Diệp ma ma
特里尼=Trini
莱布=Leib
‘马格德堡’=‘Magdeburg’
范?德兰特隆=Van Der Landron
刘香老=Lưu Hương lão
刘郑=Lưu Trịnh
香老=Hương lão
浩云=Hạo Vân
蒙长老=Mông trưởng lão
老叶=lão Diệp
叶爸爸=Diệp ba ba
家明=Gia Minh
张掌柜=Trương chưởng quỹ
朱福生=Chu Phúc Sinh
要入帮=muốn nhập bang
本帮=bản bang
小爱=tiểu Ái
智娴=Trí Nhàn
申智娴=Thân Trí Nhàn
神上神=Thần Thượng Thần
喵彦祖=Miêu Ngạn Tổ
林晨=Lâm Thần
吕晓坤=Lã Hiểu Khôn
江同学=Giang đồng học
苏情=Tô Tình
晴依=Tình Y
千夜=Thiên Dạ
宋晴依=Tống Tình Y
江千夜=Giang Thiên Dạ
天骄=Thiên Kiêu
鸿基煤矿=mỏ than Hòn Gai
姜大夫=Khương Đại Phu
丁昂=Đinh Ngang
李工长=Lý công trưởng
‘宁’=‘Ninh’
宁静=Ninh Tĩnh
小琪=tiểu Kỳ
马建军=Mã Kiến Quân
李富强=Lý Phú Cường
小夏=Tiểu Hạ
阿瑶=A Dao
曲武明=Khúc Võ Minh
曲武阳=Khúc Võ Dương
奢飞虎=Xa Phi Hổ
河老师=Hà lão sư
时洁梅=Thì Khiết Mai
姜大山=Khương Đại Sơn
史大富=Sử Đại Phú
老司=lão Ty
表姐夫=chị họ phu
向春花=Hướng Xuân Hoa
李小刚=Lý Tiểu Cương
李大刚=Lý Đại Cương
李处=Lý Xử
张彪=Trương Bưu
吉谏章=Cát Gián Chương
张智翔=Trương Trí Tường
郧素济=Vân Tố Tế
何首长=thủ trưởng Hà
quark=Quark
刘老爷=ông lớn Lưu
李落由=Lý Lạc Do
刘月菲=Lưu Nguyệt Phỉ
公孙穆寻=Công Tôn Mục Tầm
林石=Lâm Thạch
姜五=Khương Ngũ
符老爷=ông lớn Phù
林提督=Lâm đề đốc
符悦=Phù Duyệt
司乘=Ty Thừa
林富=Lâm Phú
点水=Điểm Thuỷ
巴氏=Pasteur
钱朵朵=Tiền Đoá Đoá
钱玄黄=Tiền Huyền Hoàng
裴秀莉=Bùi Tú Lị
忆柳=Ức Liễu
之桃=Chi Đào
周克=Chu Khắc
朵朵=Đóa Đóa
陈部长=Trần bộ trưởng
方主任=Phương chủ nhậm
赵传=Triệu Truyện
胡部长=Hồ bộ trưởng
熊青天=Hùng thanh thiên
李大人=Lý đại nhân
标游击=Tiêu du kích
高公=Cao công
李逢觉=Lý Phùng Giác
余葆存=Dư Bảo Tồn
李抚军=Lý phủ quân
无根据=không có căn cứ
陈大人=Trần đại nhân
陈应元=Trần Ứng Nguyên
符亚二=Phù Á Nhị
符季=Phù Quý
李巡抚=Lý tuần phủ
雅各伯=Jacob
高巡按=tuần án Cao
春霞=Xuân Hà
道了和尚=Đạo Liễu hoà thượng
道了主持=Đạo Liễu chủ trì
李存有=Lý Tồn Hữu
陈掌柜=Trần chưởng quỹ
李存发=Lý Tồn Phát
陈店主=Trần chủ tiệm
星野鹿见=Hoshino Shikami
江娘=Giang Nương
周叔=chú Chu
粱科发=Lương Khoa Phát
青霞=Thanh Hà
赛青霞=Tái Thanh Hà
小霞儿=Tiểu Hà Nhi
袁开榜=Viên Khai Bảng
罗和英=La Hoà Anh
罗白威=La Bạch Uy
罗进=La Tiến
郝生可=Hác Sinh Khả
小玉儿=Tiểu Ngọc Nhi
孙玉霖=Tôn Ngọc Lâm
文丞相=Văn thừa tướng
樊老爷=ông lớn Phàn
宋亚泗=Tống Á Tứ
罗老爷=ông lớn La
鹿见=Shikami
陈谦=Trần Khiêm
林谦=Lâm Khiêm
陈谦和=Trần Khiêm Hoà
许廷发=Hứa Đình Phát
樊文才=Phàn Văn Tài
林选=Lâm Tuyển
林拜光=Lâm Bái Quang
天澜马场=Thiên Lan Mã Trường
姜月凝=Khương Nguyệt Ngưng
北月医=Bắc Nguyệt Y
何诚宗=Hà Thành Tông
李石方=Lý Thạch Phương
石队长=đội trưởng Thạch
程展=Trình Triển
石志气=Thạch Chí Khí
老汪=lão Uông
诸彩老=Chư Thải Lão
陈亚金=Trần Á Kim
金财发=Kim Tài Phát
赵亚金=Triệu Á Kim
潘涌=Phan Dũng
陈廷=Trần Đình
鲁钦=Lỗ Khâm
吕赞画=Lã tán hoạ
吕老爷=Lữ lão gia
克伦=Karen
海盗刘=cướp biển Lưu
塔斯曼=Tasman
魏岚铎=Nguỵ Lam Đạc
魏斯?兰度=Wise? Lando
金尼阁=Kim Ni Các
特里阁=Đặc Lý Các
利玛窦=Ricci
陈连俭=Trần Liên Kiệm
集村并=Tập Thôn Bính
刘槟=Lưu Tân
董主任=chủ nhiệm Đổng
刘槟的=Lưu Tân Đích
培养基=môi trường nuôi cấy
苟师爷=Cẩu sư gia
家种=Gia Chủng
刘易初=Lưu Dịch Sơ
庆长=Keichō
殷老爷=Ân lão gia
殷承世=Ân Thừa Thế
拔贡=Bạt Cống
刘易晓=Lưu Dịch Hiểu
武鸣=Võ Minh
陈大=Trần Đại
开吊=Khai Điếu
张力平=Trương Lực Bình
吴记孟山=Ngô Ký Mạnh Sơn
吴记孟=Ngô Ký Mạnh
林碎=Lâm Toái
面瘫君=Mặt-tê-liệt-kun
甄守礼=Chân Thủ Lễ
suki=Suki
岳今古=Nhạc Kim Cổ
小姜=tiểu Khương
妙玉=Diệu Ngọc
邢忠=Hình Trung
形忠=Hình Trung
岫烟=Tụ Yên
李默=Lý Mặc
计启立=Kế Khải Lập
何邪=Hà Tà
兔兔=Usausa
艾主任=chủ nhiệm Ngải
王炎=Vương Viêm
蒋文莉=Tưởng Văn Lị
惜春=Tích Xuân
可卿=Khả Khanh
洛希亚=Lohia
卡瑟利=Caselli
黄作昀=Hoàng Tác Quân
梁波=Lương Ba
莱温斯基=Lewinsky
塞西尔=Cecil
塔莉娅=Thalia
甄倩=Chân Thiến
对工=Đối Công
陈海洋=Trần Hải Dương
马国务卿=quốc vụ khanh Mã
何总司令=tổng tư lệnh Hà
纱织=Saori
文总=sếp Văn
梦醒=Mộng Tỉnh
文首长=thủ trưởng Văn
魏大荣=Nguỵ Đại Vinh
魏主任=chủ nhiệm Nguỵ
张道长=đạo trưởng Trương
戴锷=Đái Ngạc
戴同道=Đái đồng đạo
白多禄=Bạch Đa Lộc
吴院长=viện trưởng Ngô
腐道长=Hủ đạo trưởng
腐泉=Hủ Tuyền
青铜日轮=Thanh Đồng Thiên Luân
张应宸=Trương Ứng Thần
伊龙纹=Long Văn Y
玛莎·塔布连=Martha Tabram
姓栖川=họ Sugawa
温斯里=Winsley
文森特=Vincent
帕森思=Parsons
杨媛媛=Dương Viện Viện
老熊=lão Hùng
刘牧州=Lưu Mục Châu
唐糖=Đường Đường
黄兄=Hoàng huynh
李孙乾=Lý Tôn Càn
熊逆=Hùng nghịch
吴洛=Ngô Lạc
小玲=tiểu Linh
澄茂=Trừng Mậu
杨云=Dương Vân
江别鹤=Giang Biệt Hạc
叶游击=Diệp du kích
宋家=Tống gia
宋会宗=Tống Hội Tông
陈人杰=Trần Nhân Kiệt
宋宗会=Tống Tông Hội
贾让=Giả Nhượng
李将军=Lý tướng quân
曹相蛟=Tào Tương Giao
曹将军=Tào tướng quân
毛将军=Mao tướng quân
熊茂璋=Hùng Mậu Chương
严参将=tham tướng Nghiêm
佑功=Hựu Công
月霜=Nguyệt Sương
宁静海=Ninh Tĩnh Hải
宁大夫=bác sĩ Ninh
张土木=Trương Thổ Mộc
老游=lão Du
宁渣男=Ninh tra nam
田少尉=Điền thiếu uý
王道=Vương Đạo
王熙=Vương Hy
赵千驷=Triệu Thiên Tứ
林身河=Lâm Thân Hà
何千总=Hà thiên tổng
朱全兴=Chu Toàn Hưng
雷鸣顿=Reminrton
沙见璧=Sa Kiến Bích
沙将军=Sa tướng quân
武二郎=Võ Nhị Lang
血虎=Huyết Hổ
童参将=Đồng tham tướng
刘敬选=Lưu Kính Tuyển
李光=Lý Quang
严将军=Nghiêm tướng quân
童将军=Đồng tướng quân
童以振=Đồng Dĩ Chấn
许亲兵=Hứa thân binh
钟效=Chung Hiệu
叶将军=Diệp tướng quân
孙昌祚=Tôn Xương Tộ
叶正芳=Diệp Chính Phương
李佰刀=Lý Bách Đao
何湛然=Hà Trạm Nhiên
严遵诰=Nghiêm Tuân Cáo
卡瓦=Tạp Ngoã
马矢=Mã Thỉ
贾莫非=Giả Mạc Phi
小蝴蝶=Tiểu Hồ Điệp
付三思=Phó Tam Tư
胡伯父=Hồ bá phụ
青云兄=Thanh Vân huynh
何总兵=Hà tổng binh
仲尾=Trọng Vĩ
钱太冲=Tiền Thái Xung
马千竹=Mã Thiên Trúc
文德四=Văn Đức Tứ
董微微=Đổng Vi Vi
秦良玉=Tần Lương Ngọc
何镇=Hà trấn
小素=Mito-chan
火扇=Hiougi
汤若望=Thang Nhược Vọng
李守备=Lý phòng giữ
李陌刀=Lý Mạch Đao
绫子=Ayako
李陌=Lý Mạch
萌枝=Moe
俞大帅=Du đại soái
汤将军=Thang tướng quân
余只铅=Dư Chích Duyên
游老胡=Du Lão Hồ
孙天标=Tôn Thiên Tiêu
赵汝义=Triệu Nhữ Nghĩa
老余=lão Dư
小冰=tiểu Băng
魏雨婷=Nguỵ Vũ Đình
小雪=Yuki-chan
叶媪=Diệp Ảo
余志潜=Dư Chí Tiềm
崔正=Thôi Chính
郝国新=Hác Quốc Tân
特别搜索队=đội trinh sát đặc nhiệm
游老虎=Du Lão Hổ
杨晓欣=Dương Hiểu Hân
神刀菲菲=Thần Đao Phi Phi
钱飞扬=Tiền Phi Dương
牛玉田=Ngưu Ngọc Điền
李墨棠=Lý Mặc Đường
无影剑客=Vô Ảnh Kiếm Khách
时袅任=Thời Niểu Nhậm
南海县令=Nam Hải huyện lệnh
沈掌柜=chưởng quỹ Thẩm
田老爷=Điền lão gia
裴利秀=Bùi Lợi Tú
周皇后=Chu hoàng hậu
田国丈=Điền quốc trượng
嘉定伯=Gia Định Bá
田贵妇=Điền quý phụ
田贵妃=Điền quý phi
田皇亲=Điền hoàng thân
曹履泰=Tào Lữ Thái
汤参将=Thang tham tướng
王总督=Vương tổng đốc
月牙弯刀=Nguyệt Nha Loan Đao
黛姬雪娜=Đại Cơ Tuyết Na
严定元=Nghiêm Định Nguyên
安之晓=An Chi Hiểu
宁之晓=Ninh Chi Hiểu
雷老师=Lôi lão sư
王文涛=Vương Văn Đào
朱教授=Chu giáo sư
史老师=Sử lão sư
史迪复=Sử Địch Phục
袁队长=Viên đội trưởng
风先生=Phong tiên sinh
源堂·法雷尔=Gendo · Farrell
白淑卿=Bạch Thục Khanh
法米特=Farmit
黑泽一夫=Kurosawa Kazuo
冷月樱=Lãnh Nguyệt Anh
梁某某=Lương XX
李真超=Lý Chân Siêu
郭站长=Quách trưởng trạm
梁冬冬=Lương Đông Đông
妖刀客=Yêu Đao Khách
康格里夫=Congreve
贝锦仪=Bối Cẩm Nghi
熊抚台=Hùng phủ đài
抚台大人=Phủ Đài đại nhân
姜老爷=Khương lão gia
高大人=Cao đại nhân
苏姨太=Tô di thái
石老板=Thạch lão bản
石大爷=Thạch đại gia
石老大=Thạch lão đại
董公子=Đổng công tử
俞大猷=Du Đại Du
熊制宪=Hùng chế hiến
王制台=Vương chế đài
胡宗宪=Hồ Tông Hiến
李赞画=Lý tán hoạ
袁元素=Viên Nguyên Tố
胡清白=Hồ Thanh Bạch
杨晓月=Dương Hiểu Nguyệt
周同学=Chu đồng học
周如曜=Chu Như Diệu
顾之行=Cố Chi Hành
江首长=Giang thủ trưởng
江局长=Giang cục trưởng
程逆风=Trình Nghịch Phong
王处长=Vương trưởng phòng
南直隶=Nam Trực Lệ
朱贺义=Chu Hạ Nghĩa
高大官人=đại quan nhân Cao
朱让栩=Chu Nhượng Hủ
何大春=Hà Đại Xuân
苍龙王=Thương Long vương
神阳子=Thần Dương Tử
奉安公主=Phụng An công chúa
周玉洁=Chu Ngọc Khiết
十王府=thập vương phủ
温则安=Ôn Tắc An
宁清公主=Ninh Thanh công chúa
张元吉=Trương Nguyên Cát
符宝的小道士=Phù Bảo tiểu đạo sĩ
张元庆=Trương Nguyên Khánh
弘佔真人=Hoằng Chiêm chân nhân
龙书案=long thư án
杨凌一身=Dương Lăng một thân
张白莲=Trương Bạch Liên
张将军=Trương tướng quân
曲滢滢=Khúc Huỳnh Huỳnh
袁大哥=Viên đại ca
林香袖=Lâm Hương Tụ
韩大哥=Hàn đại ca
黑天使=Hắc Thiên Sứ
于研究员=Vu nghiên cứu viên
纳兰性德=Nạp Lan Tính Đức
张应辰=Trương Ứng Thần
李莫愁=Lý Mạc Sầu
约翰·法雷尔=John · Farrell
洪老尚书=Hồng lão thượng thư
洪尚书=Hồng thượng thư
王侍郎=Vương thị lang
王翰林=Vương hàn lâm
陈洪漠=Trần Hồng Mạc
陆仲昆=Lục Trọng Côn
王三公子=Vương tam công tử
程文义=Trình Văn Nghĩa
黄子维=Hoàng Tử Duy
陆什长=Lục thập trường
陆恩橹=Lục Ân Lỗ
高家小姐=Cao gia tiểu thư
戴公公=Đái công công
倪大人=Nghê đại nhân
赵简之=Triệu Giản Chi
静公公=Tĩnh công công
杨院判=Dương viện phán
白陀山=Bạch Đà Sơn
右韶舞=hữu thiều vũ
三指田=Tam Chỉ Điền
戴员外=Đái viên ngoại
司空明=Tư Không Minh
高文兰=Cao Văn Lan
高文举=Cao Văn Cử
高廷正=Cao Đình Chính
高文心=Cao Văn Tâm
高太医=Cao thái y
高廷和=Cao Đình Hoà
高员外=Cao viên ngoại
杨詹事=Dương chiêm sự
王尚书=Vương thượng thư
三千六百个=3600 cái
马文生=Mã Văn Sinh
杨凌笑=Dương Lăng cười
焦侍郎=Tiêu thị lang
焦爱卿=Tiêu ái khanh
王老尚书=Vương lão thượng thư
刘都司=Lưu đô ty
李宗周=Lý Tông Chu
刘文泰=Lưu Văn Thái
孝宗皇帝=Hiếu Tông hoàng đế
焦大人=Tiêu đại nhân
马文升=Mã Văn Thăng
彭继祖=Bành Kế Tổ
连麻子=Liên mặt rỗ
连得禄=Liên Đắc Lộc
李娘娘=Lý nương nương
鲍尽忱=Bào Tận Thầm
刘绍忠=Lưu Thiệu Trung
苏谨言=Tô Cẩn Ngôn
鲍尽忠=Bào Tận Trung
胡中军=Hồ trung quân
杨凌大人=Dương Lăng đại nhân
彭大胖子=Bành đại mập mạp
鲍大人=Bào đại nhân
刘士庸=Lưu Sĩ Dung
鲍参将=Bào Tham Tướng
鲍尽沈=Bào Tận Thẩm
牛继宗=Ngưu Kế Tông
寒里梅=Hàn Lý Mai
裴远瘫=Bùi Viễn Than
裴东来=Bùi Đông Lai
吴清远=Ngô Thanh Viễn
顾山河=Cố Sơn Hà
金针刘=Kim Châm Lưu
张骏鸣=Trương Tuấn Minh
金枝娇=Kim Chi Kiều
胡木野=Hồ Mộc Dã
吴迪轻=Ngô Địch Khinh
张鹤龄=Trương Hạc Linh
张延龄=Trương Diên Linh
黄台吉=Hoàng Đài Cát
范文程=Phạm Văn Trình
李老板=Lý ông chủ
李宇宙=Lý Vũ Trụ
雪里梅=Tuyết Lý Mai
香宝儿=Hương Bảo Nhi
可卿儿=Khả Khanh Nhi
李科林=Lý Khoa Lâm
卓志奇=Trác Chí Kỳ
刘大夏=Lưu Đại Hạ
谷大用=Cốc Đại Dụng
沙思各=Shathge
柳、杨=Liễu, Dương
朱洪武=Chu Hồng Võ
杨一清=Dương Nhất Thanh
韩满仓=Hàn Mãn Thương
闵文建=Mẫn Văn Kiến
杨顺德=Dương Thuận Đức
关受英=Quan Thụ Anh
郑一鄂=Trịnh Nhất Ngạc
王承宪=Vương Thừa Hiến
博达尔=Bác Đạt Nhĩ
贺士杰=Hạ Sĩ Kiệt
马伶儿=Mã Linh Nhi
明成祖=Minh Thành Tổ
郑大鹏=Trịnh Đại Bằng
孙大中=Tôn Đại Trung
孙大忠=Tôn Đại Trung
旭烈孛齐=Húc Liệt Bột Tề
徐天琦=Từ Thiên Kỳ
沃尔霍达=Volhoda
韩师爷=sư gia Hàn
冯师爷=Phùng sư gia
李大掌柜=Lý chưởng quỹ lớn
李成梁=Lý Thành Lương
何方回=Hà Phương Hồi
林功勋=Lâm Công Huân
朝香明惠=Asaka Myōe
武田真澄=Takeda Masumi
艾大夫=Ngải bác sĩ
时博士=Thời bác sĩ
沐剑屏=Mộc Kiếm Bình
玉娇龙=Ngọc Kiều Long
张大掌柜=Trương đại chưởng quỹ
派拉贝鲁姆=Palabellum
韦伯利=Webley
马卡洛夫=Makarov
德林杰=Delinger
午首长=Ngọ thủ trưởng
姚云兰=Diêu Vân Lan
董首长=Đổng thủ trưởng
李、邓=Lý, Đặng
邓常恩=Đặng Thường Ân
李孜省=Lý Tư Tỉnh
黄奇胤=Hoàng Kỳ Dận
关盼盼=Quan Phán Phán
苏颜汐=Tô Nhan Tịch
王养正=Vương Dưỡng Chính
粱存厚=Lương Tồn Hậu
陆小娘=Lục Tiểu Nương
陆守业=Lục Thủ Nghiệp
陆初一=Lục Sơ Nhất
捷尔任斯基=Dzerzhinsky
闵、马=Mẫn, Mã
韩幼娘=Hàn Ấu Nương
严世藩=Nghiêm Thế Phiên
郑少鹏=Trịnh Thiếu Bằng
艾弥薇=Emilvy
格莱希娅=Grecia
伊南娜=Inanna
艾丝塔蒂=Estati
多崎君=Tasaki-kun
小野寺惠里=Onodera Erii
岛本佳柰=Shimamoto Kana
小野寺=Onodera
星野刚雄=Hoshino Takeo
铃木圭太=Suzuki Keita
川越里美=Kawagoe Satomi
村上君=Murakami-kun
kiki=Kiki
山内顺一=Yamanouchi Shunji
岛本佳奈=Shimamoto Kana
矢岛叶月=Yajima Hazuki
袁小忆=Viên Tiểu Ức
方郁森=Phương Úc Sâm
梁希成=Lương Hi Thành
个人才=cái nhân tài
莫裳娫=Mạc Thường Duyên
赵韶华=Triệu Thiều Hoa
杨师长=Dương sư trưởng
林折月=Lâm Chiết Nguyệt
维若拉=Verola
陈也俊=Trần Dã Tuấn
卫若兰=Vệ Nhược Lan
川上远=Kawakami Akira
米姬氏=Mễ Cơ thị
姬初月=Cơ Sơ Nguyệt
周南心=Chu Nam Tâm
米沛岚=Mễ Bái Lam
高胜男=Cao Thắng Nam
米正业=Mễ Chính Nghiệp
米一刀=Mễ Nhất Đao
赵某人=Triệu mỗ
苏医师=Tô y sư
苏医仙=Tô y tiên
安洁拉=Angela
狄学弟=Địch học đệ
张先生=Trương tiên sinh
狄伟才=Địch Vĩ Tài
沈秀娟=Thẩm Tú Quyên
香夫人=Hương phu nhân
莫闻声=Mạc Văn Thanh
福寿来=Phúc Thọ Lai
李寻巧=Lý Tầm Xảo
旗仲雄=Kỳ Trọng Hùng
叶树生=Diệp Thụ Sinh
曾志峰=Tằng Chí Phong
轻公子=Khinh công tử
庞志泽=Bàng Chí Trạch
南宫云=Nam Cung Vân
米大人=Mễ đại nhân
伊子轩=Y Tử Hiên
曾大人=Tằng đại nhân
伊斋长=Y trai trưởng
蓝堂长=Lam đường trường
江阳文=Giang Dương Văn
江山长=Giang sơn trưởng
蓝鸿征=Lam Hồng Chinh
米将军=Mễ tướng quân
曾茜茜=Tằng Thiến Thiến
曾善芳=Tằng Thiện Phương
曾三万=Tằng Tam Vạn
伴月妃=Bạn Nguyệt Phi
楚公子=Sở công tử
楚离人=Sở Ly Nhân
程嘉月=Trình Gia Trăng
曾郡守=Tằng quận thủ
米大将军=Mễ đại tướng quân
常织织=Thường Chức Chức
秦凤安=Tần Phượng An
关公子=Quan công tử
赵公子=Triệu công tử
灵童真人=Linh Đồng Chân Nhân
商九问=Thương Cửu Vấn
陆卓川=Lục Trác Xuyên
孟师兄=Mạnh sư huynh
商九只=Thương Cửu Chích
孟公子=Mạnh công tử
聂隐正=Niếp Ẩn Chính
璩灵洞=Cừ Linh Động
虞南棠=Ngu Nam Đường
孟长歌=Mạnh Trường Ca
墨菲斯托菲利斯=Mephistopheles
哈贝尔=Harbel
马尔可=Marco
安拉睿尔=Amlaruil
关山路=Quan Sơn Lộ
轻夫人=Khinh phu nhân
艾拉丝卓=Alustriel
米太傅=Mễ thái phó
小权权=tiểu Quyền Quyền
塔拉夏=Tal Rasha
米夫人=Mễ phu nhân
莎洛克=Sarok
郭穆清=Quách Mục Thanh
江晨濡=Giang Thần Nhu
华瀚文=Hoa Hãn Văn
鲍若艺=Bào Nhược Nghệ
小玲珑=tiểu Linh Lung
醉乡梦=Tuý Hương Mộng
格莱希雅=Glasya
曼熊斯基=Manxionsky
轻少爷=Khinh thiếu gia
莱维斯图斯=Levistus
熊斯基=Schunsky
毕莱尔=Belial
摩洛克=Moloch
阿德拉玛雷士=Adramalech
玲珑兽=thú Linh Lung
朱李氏=Chu Lý thị
朱才举=Chu Tài Cử
轻天下=Khinh Thiên Hạ
卡萨克=Kasak
阮依秋=Nguyễn Y Thu
林正安=Lâm Chính An
水如黛=Thuỷ Như Đại
水如烟=Thuỷ Như Yên
宁凝霜=Ninh Ngưng Sương
任盈盈=Nhậm Doanh Doanh
许天佑=Hứa Thiên Hữu
薛紫苑=Tiết uyển tím
萧一可=Tiêu Nhất Khả
波波姐=Sóng Sóng tỷ
东方怜人=Đông Phương Liên Nhân
程流苏=Trình Lưu Tô
夏若若=Hạ Nhược Nhược
厄加特=Urgot
沙漠皇帝=Azir
时光老头=Zilean
克里斯多夫=Christopher
莎琳娜=Sharinna
卢管事=Lư quản sự
亚戈达=Yagoda
赵曼熊=Triệu Mạn Hùng
安博理=Umberlee
何仵作=Hà ngỗ tác
方大小姐=Phương đại tiểu thư
祝郡守=Chúc quận thủ
林神医=Lâm thần y
三步毒君=Tam Bộ Độc Quân
轻英杰=Khinh Anh Kiệt
轻南天=Khinh Nam Thiên
惊涛龟=Kinh Đào Quy
火云掌=Hoả Vân Chưởng
逍遥行=Tiêu Dao Hành
方凡依=Phương Phàm Y
潘祖瑞尔=Panzuril
轻王权=Khinh Vương Quyền
水熊君=Thuỷ Hùng Quân
赵九神=Triệu Cửu Thần
琉璃支=Lưu Ly Chi
安奇生=An Kỳ sinh
崔拓玉=Thôi Thác Ngọc
终葵镜伊=Chung Quỳ Kính Y
嵇夫子=Kê Phu Tử
姚胖子=Diêu mập mạp
小飞儿=Tiểu Phi Nhi
小壳子=Tiểu Xác Tử
菖蒲姐=Xương Bồ tỷ
叶利钦=Yeltsin
王朝美人=vương triều mỹ nhân
志村凉介=Shimura Ryosuke
斋藤步=Saitō Ayumu
佐佑理=Sayuri
木下优=Kinoshita Yu
斋藤伦子=Saitō Noriko
布雷纳斯=Brennus
千鹤子=Chizuko
神山茂=Kamiyama Shigeru
欧贝伦=Oberon
路大董事长=Lộ đại chủ tịch
伊奥勒姆=Ioulaum
康杰诺=Congenio
西凡纳斯=Silvanus
路小姐=Lộ tiểu thư
路老板=Lộ lão bản
林学姐=Lâm học tỷ
姜学姐=Khương học tỷ
宁芷若=Ninh Chỉ Nhược
阿拉莎=Alashar
海王哥哥=Hải Vương ca ca
徐阿姨=Từ a di
吉尔伽美什=Gilgamesh
提亚玛特=Tiamat
察斯萨=Tchazzar
姜叔叔=Khương thúc thúc
萨玛斯特=Sammaster
迪内特=Dinette
路叔叔=Lộ thúc thúc
伊格维尔伏=Iggwilv
阿斯蒂莫斯=Asmodeus
宁太后=Ninh thái hậu
路董事长=Lộ chủ tịch
庞天山=Bàng Thiên Sơn
仇星河=Cừu Tinh Hà
姜茶茶=Khương Trà Trà
阿穆尔=Aeumal
海拉斯帝=Hethradiah
顾茶茶=Cố Trà Trà
林茶茶=Lâm Trà Trà
科斯彻奇=Kostchtchie
美坎修特=Malcanthet
伊尔明斯特=Elminster
艾拉斯卓=Alustriel
卡尔萨斯=Karsus
阿祖斯=Azuth
坂本君=Sakamoto-kun
乔同学=Kiều đồng học
夏目诗歌=Natsume Shiika
坂本和也=Sakamoto Kazuya
铃鹿酱=Suzuka-chan
山科有马=Yamashina Yuuki
加藤贵也=Katou Takaya
行明法师=Hành Minh pháp sư
田村铃鹿=Tamura Suzuka
大岛桑=Ojima-san
坐山观茶斗=toạ sơn quan trà đấu
平田宏=Hirata Hiro
平田京子=Hirata Kyoko
幸之助=Konosuke
孟月娥=Mạnh Nguyệt Nga
亚梨子酱=Yariko-chan
平田幸之助=Hirata Konosuke
藤原绫乃=Fujiwara Ayano
幸德井雅人=Kotokui Masato
德井雅人=Tokui Masato
姜神医=Khương thần y
覃子桂=Đàm Tử Quế
路99=Lộ 99
顾大女神=Cố đại nữ thần
大岛一夫=Ojima Kazuo
小宁同志=Tiểu Ninh đồng chí
爱丽丝酱=Alice-chan
小韭菜精=rau hẹ tinh nhỏ
新井桑=Arai-san
浅野爱丽丝酱=Asano Alice-chan
大和田=Ohwada
井上贵=Inoue Takashi
维拉多伦=Veladorn
圣人惠=Katou Megumi
阎欢心=Diêm Hoan Tâm
吉勒今=Gilgeam
莎罕妮=Sehanine
齐雅温纱丽=Kiaransalee
关纳德=Ghaunadaur
席文塔姆=Selvetarm
柯瑞隆=Corellon
伊莉丝翠=Eilistraee
姜老师=Khương lão sư
卡洛拉=Carola
宁源哥=Ninh Nguyên ca
杨教授=Dương giáo sư
龙王修罗=Long Vương Tu La
博克本=Blacrabban
查丽丝瑞=Chalithra
维康尼亚=Viconia
坦帕斯=Tempus
菲尔伦=Phillorn
费马罗=Fenmarel
莫斯德林=Mestarine
小憨批=nhỏ khờ phê
祖格莫伊=Zuggtmoy
查梧础=Tra Ngô Sở
孟绿茶=Mạnh lục trà
歪嘴战神=Miệng Méo Chiến Thần
小顾同志=Tiểu Cố đồng chí
宁某人=Ninh mỗ nhân
谜语人=Riddler
顾卿家=Cố khanh gia
姜卿家=Khương khanh gia
宁碧莲=Ninh bích liên
姜大师=Khương đại sư
宁先生=Ninh tiên sinh
姜小姐=Khương tiểu thư
顾大工具人=Cố đại công cụ nhân
王阿姨=Vương a di
陈渣男=Trần tra nam
浅野庄司=Asano Shoji
慕容满月=Mộ Dung Mãn Nguyệt
慕容源=Mộ Dung nguyên
品茶王=Phẩm Trà Vương
小零儿=Tiểu Linh nhi
林大师=Lâm đại sư
石田浩二=Ishida Koji
月见樱泽=Tsukimi Sakura
咔密Sama=Kami-sama
林断山=Lâm Đoạn Sơn
林师兄=Lâm sư huynh
林师弟=Lâm sư đệ
石大小姐=Thạch đại tiểu thư
段天宝=Đoàn Thiên Bảo
徐清怜=Từ Thanh Liên
凤凰仙子=Phượng Hoàng tiên tử
秋大师兄=Thu đại sư huynh
紫薇真人=Tử Vi chân nhân
冥华长老=Minh Hoa trưởng lão
娄师兄=Lâu sư huynh
凌师弟=Lăng sư đệ
石鼎长老=Thạch Đỉnh trưởng lão
赵文成=Triệu Văn Thành
阴鬼道=Âm Quỷ Đạo
胡浩之胡师兄=Hồ Hạo Chi Hồ sư huynh
胡师兄=Hồ sư huynh
徐师姐=Từ sư tỷ
胡浩之=Hồ Hạo Chi
柳依依=Liễu Y Y
刘道然=Lưu Đạo Nhiên
徐大师兄=Từ đại sư huynh
石子明=Thạch Tử Minh
米斯巴拉卡兹=Mithbarakaz
石琉璃=Thạch Lưu Ly
井口健二=Iguchi Kenji
井口哲=Iguchi Satoshi
铃村透=Namura Toru
浅野亚梨子=Asano Yariko
亚梨子=Yariko
简青楠=Giản Thanh Nam
钟天槐=Chung Thiên Hoè
秋师兄=Thu sư huynh
颜之推=Nhan Chi Thôi
徐师妹=Từ sư muội
娄知正=Lâu Tri Chính
七杀真人=Thất Sát chân nhân
紫云峰峰=Tử Vân phong phong
冥华真人=Minh Hoa chân nhân
沙玛斯=Sshamath
割草剑仙=Cát Thảo Kiếm Tiên
晶川结衣=Akikawa Yui
安师姐=An sư tỷ
安知素=An Tri Tố
凌云破=Lăng Vân Phá
紫薇掌教=Tử Vi chưởng giáo
徐应怜=Từ Ứng Liên
秋长天=Thu Trường Thiên
蒙象德=Mông Tượng Đức
新井慎之介=Arai Shinnosuke
慎之介=Shinnosuke
伽椰子=Kayako
佐仓桑=Sakura-san
土御门桑=Tsuchimikado-san
星川御言=Hoshikawa Mikoto
土御门清明=Tsuchimikado Seimei
井伊正治=Ii Masaharu
峰城大学=đại học Minjo
玛拉斯=Malath
藤泽三郎=Fujisawa Saburo
顾小姐=Cố tiểu thư
顾庄主=Cố trang chủ
萨马斯特=Sammaster
迪瓦克=Divak
德蜜拉=Dmitra
弗雷斯=Flass
艾格拉瑞=Aglarel
科拉瑞博纳斯=Clariburnus
麦勒刚特=Melegaunt
德苏得=Dethud
拉莫来克=Lamorak
德拉克萨斯=Druxus
奈弗朗=Nevron
蕾拉芮=Lallara
劳泽瑞尔=Lauzoril
阿兹纳=Aznar
柳水心=Liễu Thuỷ Tâm
北原无村=Kitahara Mumura
雅菲尔=Yaphyll
艾尔塔柏=Eltabbar
塔洛斯=Talos
维沙伦=Velsharoon
井田上二=Ida Ueji
龟田浩=Kameda Hiroshi
花山院凌奈=Kazanin Ryona
花山院=Kazanin
清水白石=Shimizu Shiraishi
傅玄序=Phó Huyền Tự
少浮屠=Thiếu Phù Đồ
大贺真人=Taiga Makoto
橘知墨=Tachibana Chika
浅野夏织=Asano Kaori
三田拓马=Mitsuda Takuma
白川泽平=Shirakawa Sohei
羽生千歌=Hanyu Chika
清人君=Kiyoto-kun
源清人=Minamoto Kiyoto
源永德=Minamoto Eitoku
清素君=Kiyomoto-kun
藤原紫乃=Fujiwara Shino
柿麻吕=Kakimaro
神巫大人=thầy cúng đại nhân
源清显=Minamoto Kiyoshi
宁听山=Ninh Thính Sơn
源清美=Minamoto Kiyomi
源清音=Minamoto Kiyone
的冬岚=Touran
大仲马=Dumas
建一郎=Kenichiro
邹子石=Trâu Tử Thạch
鲁智浅=Lỗ Trí Thiển
顾士嵩=Cố Sĩ Tung
万卷上人=Vạn Cuốn Thượng Nhân
伊达政宗=Date Masamune
水天巫女=Suiten miko
清少爷=Kiyo thiếu gia
安德烈希=Andreich
麻宫樱=Asamiya Sakura
雨宫真理=Amamiya Mari
雨宫乃亚=Amamiya Noya
郑二根=Trịnh Nhị Căn
海首长=Hải thủ trưởng
文家兄弟=nhà họ Văn anh em
凯尔本=Khelben
米尔寇=Myrkul
魔瑞莎=Morasha
糸见雪=Itomi Yuki
糸见沙耶加=Itomi Sayada
沙耶加=Sayada
糸见沙耶=Itomi Saya
毗桓罗=Tì Hoàn La
三千子=Michiko
柳生三千子=Yagyuu Michiko
姬宫十六夜=Himemiya Izayoi
十六夜=Izayoi
瓦提克=Vattick
玛提克=Mattick
瑞瓦兰=Rivalen
木花开耶姬=Konohananosakuyahime
常叔叔=chú Thường
飞脚老三=Phi Cước Lão Tam
“巨寇”郑芝龙=“Cự khấu” Trịnh Chi Long
王头儿=đầu lĩnh Vương
梅斯迪尔=Mestil
瑞哈格拉斯=Rhaugilath
三四郎=Sanshirou
御子大人=Miko-sama
神林御子=Kamibayashi Miko
渡边悠=Watanabe Yu
源清素=Minamoto Kiyomito
野千鹤子=Mifune Chizuko
塔洛娜=Talona
欧吕尔=Auril
拉路波=Larup
西行妖=Saigyou Ayakashi
萨扎斯坦=Szass Tam
藤原家=nhà Huziwara
莉法儿=Lifale
田伯光=Điền Bá Quang
伊尔玛特=Ilmater
贝纳索=Benazo
死之天使=Thiên Sứ Tử Vong
伊莉丝=Elis
伊格纯明=Ikei Toshiaki
幽香女王=Yuuka Nữ Vương
罗珊娜=Roxanne
千惠子=Chieko
小川清美=Ogawa Kiyomi
三上沙也=Mikami Saya
伊尔坦=Eltan
李尽杯=Lý Tận Bôi
米莉亚姆=Miirym
拉沃克=Larloch
高临渊=Cao Lâm Uyên
佳织酱=Kaori-chan
元开霁=Nguyên Khai Tễ
霍杰哈纳=Hadrhune
八云红=Yakumo Akari
八云家=nhà Yakumo
藤原胧也=Fujiwara Oboro
欧格玛=Oghma
泰摩拉=Tymora
贝尔塔=Belt
秋田瑠美=Akita Rumi
莎珞克=Sarok
玉置龙也=Tamaki Tatsuya
拉杜格=Laduguer
明日梨花=Akehi Rika
小林由季子=Komori Yukiko
丹吉尔=Tangier
莫拉丁=Moradin
上西里佳=Uenishi Rika
九条真姬=Kujou Maki
盖兹比=Gasby
千千子=Chichiko
蒂娜岑=Denarthun
九条伸介=Kujou Shinsuke
坦纳斯=Thanas
克劳蒂斯=Claudius
普瑞尼克=Prinik
由季子=Yukiko
清野里子=Seino Riko
清野神=Thần Seino
清野凛=Seino Rin
渡边猫=Watanabe mèo
卡琳娜=Karina
小真衣=Mai-chan
藤木晃子=Fujiki Akiko
里勒萨=Lilesa
剑桥飞鸟=Cambridge Aska
兰尼斯特=Lannister
koko酱=koko-chan
耶诺古=Yeenoghu
和美酱=Kazumi-chan
真衣酱=Mai-chan
和穗酱=Kazuo-chan
狄魔高根=Demogorgon
格拉兹特=Graz'zt
林奈和穗=rừng nại Kazuo
奥喀斯=Orcus
堀北真衣=Horikita Mai
阿曼纳塔=Amaunator
兰森德尔=Lathander
塞利纳=Céline
加世子=Kayoko
今井加世子=Imai Kayoko
清野神教=Kiyono thần giáo
枝阿姨=Eda a di
渡边莲=Watanabe Ren
吉田玲子=Yoshida Reiko
渡边恒雄=Watanabe Tsuneo
渡边枝=Watanabe Eda
曾书飞=Tằng Thư Phi
林秋寒=Lâm Thu Hàn
宫下柰柰=Miyashita Nana
苏清歌=Tô Thanh Ca
麻衣桑=Mai-san
犬山葵=Inuyama Aoi
顾长歌=Cố Trường Ca
明日香=Asuka
多啦A凛=Doraerin
田中明日香=Tanaka Asuka
吴家窑=Ngô Gia Diêu
黄前久美子=Oumae Kumiko
朱老师=Chu lão sư
诺洛夫=Norov
大路饼藏=Oji Mochizo
铠冢霙=Yoroizuka Mizore
静老师=Shizuka lão sư
久美子=Kumiko
马林诺夫斯基=Malinowski
白司铎=linh mục Bạch
侍奉部=CLB Tình Nguyện
小霍克=Tiểu Hawke
韦尔斯利=Wellesley
宇智波斑=Uchiha Madara
千手柱间=Senju Hashirama
克里托=Krito
清水和音=Shimizu Kazune
哆啦A凛=Dorae-rin
朝比奈实玖瑠=Ashahina Mikuru
实玖瑠=Mikuru
姓欲女神=Tính Dục nữ thần
鹰司道=Takashido
池田和美=Ikeda Kazumi
白濑景子=Shirase Keiko
洛修寒=Lạc Tu Hàn
羽土真衣=Hadzuchi Mai
亚美酱=Ami-chan
白未央=Bạch Vị Ương
武绫空=Võ Lăng Không
北原早绘=Kitahara Haye
长谷春=Hasebe Haru
皇甫云=Hoàng Phủ Vân
丹羽幸=Niwa Yuki
佐藤律子=Satou Ritsuko
早见熏=Hayami Kaoru
小松美咲=Komatsu Misaki
九条藤=Kujou Fuji
明日学姐=Akehi học tỷ
一木葵=Ichiki Aoi
华晨宇=Hoa Thần Vũ
明日麻衣=Akehi Mai
谵天雄=Chiêm Thiên Hùng
萨林娜=Salina
李亚阳=Lý Á Dương
鲍克瑟=Boxer
杨二根=Dương Nhị Căn
郑民基=Jung Min-ki
罗卿媛=Na Kyung-won
郑睿宣=Chung Ye-seon
克劳迪亚.薇芙=Claudia Wave
李无忧=Lý Vô Ưu
神秘博士=Doctor Who
池田纪子=Ikeda Kiko
小须一树=Kosu Kazuki
许南植=Hur Nam-sik
西川雄=Nishikawa Takeshi
长谷百香=Hase Momoka
花田朝子=Hanada Asako
宫崎美雪=Miyazaki Miyaki
东们大官人=Đông Môn đại quan nhân
金载烈=Kim Jae-yeol
李叙显=Lee Seo-hyun
洪罗喜=Hong Ra-hee
钱长水=Tiền Trường Thuỷ
孙怡琦=Tôn Di Kỳ
郑大水=Trịnh Đại Thuỷ
包伯红=Bao Bá Hồng
紫电改=Kawanishi N1K
九条美姬=Kujou Miki
吉桓永=Gil Hwan-Young
新海诚=Shinkai Makoto
黑田幸惠=Kuroda Yukie
袁灿裕=Viên Xán Dụ
沈锡林=Thẩm Tích Lâm
莫妮卡=Monica
村井千春=Murai Chiharu
千春姐=Chiharu-nee
渡边君=Watanabe-kun
玉藻好美=Tamamo Yoshimi
小泉青奈=Koizumi Aona
触手大小姐=Xúc Tu đại tiểu thư
吴桂芳=Ngô Quế Phương
李子昵=Lý Tử Nặc
屠自古=Toziko
孙二娘=Tôn Nhị Nương
苏我屠自古=Soga no Toziko
物部布都=Mononobe no Futo
刘宇哲=Lưu Vũ Triết
韩莹莹=Hàn Oánh Oánh
韩心水=Hàn Tâm Thuỷ
褚莹莹=Chử Oánh Oánh
王昭夕=Vương Chiêu Tịch
张璐瑶=Trương Lộ Dao
亨特.科罗德=Hunter Corod
方某人=Phương mỗ nhân
GIOGIO=GIOGIO
布鲁诺=Bruno
米斯达=Mista
克里斯蒂=Christie
布加拉提=Bucciarati
纳兰迦=Narancia
乔巴那=Giovanna
布兰度=Brando
季退思=Quý Thối Tư
特莉休=Trish
亚波罗=Apollo
DIO=DIO
阿帕基=Abbacchio
乌鲁托拉曼=Ultraman
安洛斯=Amroth
汉考克=Hancock
斯达汉诺夫=Stakhanov
阿妹你看=a muội ngươi xem
黄师傅=Hoàng sư phó
蒋姑娘=Tưởng cô nương
汤矿长=Thanh trưởng mỏ
叶师傅=Diệp sư phó
弗兰克斯=Franks
蕾茜雅=Lesia
门矢士=Decade
乡秀树=Gou Hideki
蒋雯莉=Tưởng Văn Lỵ
海总管=Hải tổng quản
陈管事=Trần quản sự
崔顺实=Choi Soon-sil
绿巨人=Hulk
张太爷=Trương thái gia
达尼索斯=Danisos
圣玛利亚=Santa Maria
尤瑟纳尔=Usnar
萨利瓦尔=Salival
伯利斯坦=Belestan
梅坎特隆=Mecantron
高兄弟=Cao huynh đệ
布拉内斯=Blanes
阿图曼=Atuman
孙师傅=Tôn sư phó
诸大掌柜=Chư chưởng quỹ lớn
蒂亚戈=Tiago
卢主任=Lư chủ nhiệm
贝德伦卡=Bedlenka
巴索尔=Basol
巴恩斯=Barnes
金克斯=Jinx
哈莉奎茵=Harley Quinn
沙福林=Shaferin
崔佛·菲利普=Trevor · Philips
织田信长=Oda Nobunaga
拉格莱=Lalegue
拉莱格=Lalegue
伦德尔=Lendl
瑟维特=Servetus
哈姆斯=Harms
安图内斯=Antunes
阿尔瓦罗=Alvaro
玛丽亚娜=Mariana
安赫拉=Angera
巴尔扎利=Balzali
阿戈斯蒂纽=Agostinho
艾莉卡=Erica
里莫先生=Rimo tiên sinh
巴拉迪=Baradei
格威尔=Gewell
匹里马斯=Pirimas
瓦尔·亚伦德=Var · Aaronde
马本元=Mã Bản Nguyên
汤允问=Thang Doãn Vấn
蒋有龄=Tưởng Hữu Linh
蒋若龄=Tưởng Nhược Linh
汤允文=Thang Doãn Văn
符二壮=Phù Nhị Tráng
符三壮=Phù Tam Tráng
德凡特=Defant
迪圣塔=De Santa
菲利普=Philips
戴夫·诺顿=Dave · Norton
纪登高=Kỷ Đăng Cao
季等高=Quý Đẳng Cao
符一壮=Phù Nhất Tráng
戈培尔=Goebbels
蒋宏军=Tưởng Hoành Quân
金喜善=Kim Hee-sun
刘姑娘=Lưu cô nương
刘美兰=Lưu Mỹ Lan
薛之杰=Tiết Chi Kiệt
王明刚=Vương Minh Cương
李明刚=Lý Minh Cương
宫二小姐=Cung Nhị tiểu thư
骗术师=Kẻ Lừa Đảo
卢生严=Lư Sinh Nghiêm
周老爷=Chu lão gia
尤国团=Vưu Quốc Đoàn
孙娜恩=Son Na-eun
林长三=Lâm Trường Tam
孙老爷=Tôn lão gia
孙瑞伍=Tôn Thuỵ Ngũ
孙典史=Tôn điển sử
井上邦雄=Inoue Kunio
黄老头子=Hoàng lão đầu tử
苏老哥=Tô lão ca
李孝朋=Lý Hiếu Bằng
黄进士=Hoàng tiến sĩ
黄二少爷=Hoàng nhị thiếu gia
布鲁格=Brugg
叶老师=Diệp lão sư
方老师=Phương lão sư
郧首长=Vân thủ trưởng
林清杰=Lâm Thanh Kiệt
杨贤硕=Yang Hyun-suk
勋首长=Huân thủ trưởng
郧老爷=Vân lão gia
张老爷=Trương lão gia
刘光表=Lưu Quang Biểu
拉鲁斯=Larousse
阿狄丽娜=Adeline
陈八爷=Trần Bát Gia
赵亮镐=Cho Yang-ho
叶长空=Diệp Trường Không
苏少爷=Tô thiếu gia
宫若梅=Cung Nhược Mai
奥克塔夫=Octave
孙穆见=Tôn Mục Kiến
许泰烈=Heo Tae-Yeol
陈书办=Trần thư biện
陈民刚=Trần Dân Cương
凯子哥=Khải Tử ca
王先生=Vương tiên sinh
乔鲁诺·乔巴纳=Giorno · Giovanna
乔鲁诺=kiều dạ lỗ
乔巴纳=Giovanna
苏老板=Tô lão bản
玛丽珍=Mary Jane
埃姆登=Emden
索拉霍=Sorajo
路西恩·伊文斯=Lucian Evans
黄警官=Hoàng cảnh quan
索伦芬=Sauron phân
苏二少=Tô nhị thiếu
苏大哥=Tô đại ca
梅尔莫斯=Melmos
蒂罗尼=Tironi
林逸天=Lâm Dật Thiên
内克瑟=Nexer
方老弟=Phương lão đệ
方老哥=Phương lão ca
马尔迪摩斯=Maldives
徐匡复=Từ Khuông Phục
安吉尔=Angel
汤姆·史密斯=Tom · Smith
马萨达=Masada
路西恩=Lucian
提里斯=Tbilisi
里德维奇=Lidewij
小米娅=nhỏ Mea
林振华=Lâm Chấn Hoa
王奕豪=Vương Dịch Hào
夏姑娘=Hạ cô nương
青大人=Thanh đại nhân
许十安=Hứa Thập An
李玉英=Lý Ngọc Anh
夏女士=Hạ nữ sĩ
夏小姐=Hạ tiểu thư
王老师=Vương lão sư
夏晚桃=Hạ Vãn Đào
夏雾雨=Hạ Vụ Vũ
王叶伦=Vương Diệp Luân
方大哥=Phương đại ca
凛大小姐=Lẫm đại tiểu thư
梅塔宁=Metanen
方唐镜=Phương Đường Kính
格罗宁=Groning
方先生=Phương tiên sinh
徐经理=Từ giám đốc
苏公子=Tô công tử
苏二哥=Tô nhị ca
黑森格=Hesenger
胡苏姆=Husum
张曦兮=Trương Hi Hề
苏大老板=Tô đại lão bản
赫尔蒙斯=Hermons
达尼埃尔=Daniel
赵秋梅=Triệu Thu Mai
安格瑞=Angourie
苏老爹=Tô lão tía
苏校长=Tô hiệu trưởng
苏大小姐=Tô đại tiểu thư
陈永仁=Trần Vĩnh Nhân
吉良吉影=Kira Yoshikage
苏小妹=Tô tiểu muội
燕双鹰=Yến Song Ưng
苏妹子=Tô muội tử
苏叔叔=Tô thúc thúc
苏大爷=Tô đại gia
西门天=Tây Môn Thiên
张落羽=Trương Lạc Vũ
宋无涯=Tống Vô Nhai
全英禄=Jeon Yeong-rok
无忘生=Vô Vong Sinh
赵有德=Triệu Hữu Đức
李美英=Lee Mi-Young
谢施主=Tạ thí chủ
谢姑娘=Tạ cô nương
郑容和=Jung Yong-hwa
曲大侠=Khúc đại hiệp
朱冬永=Chu Đông Vĩnh
岳大叔=Nhạc đại thúc
岳东来=Nhạc Đông Lai
曲大人=Khúc đại nhân
阳宗主=Dương tông chủ
周伯韬=Chu Bá Thao
阳根硕=Dương Căn Thạc
阳巨基=Dương Cự Cơ
刑开天=Hình Khai Thiên
刘三刀=Lưu Tam Đao
紫玉师弟=Tử Ngọc sư đệ
曲前辈=Khúc tiền bối
桂言叶=Katsura Kotonoha
陆昆吾=Lục Côn Ngô
白展堂=Bạch Triển Đường
曲公子=Khúc công tử
叶姑娘=Diệp cô nương
盛姑娘=Thịnh cô nương
曲施主=Khúc thí chủ
兰陵翁=Lan Lăng Ông
嘉琳娜=Galina
莫德罗=Modrow
皮罗特=Pirot
贝亚思=Beiyasi
伊露娜=Iluna
克劳恩=Crown
考辛斯=Cousins
索尔纳=Solna
阿樊多=Afando
巴布尔=Babur
安格诺玛=Angroma
安纳坦斯=Anatans
东承惜=Đông Thừa Tích
白韶华=Bạch Thiều Hoa
吴某人=Ngô mỗ nhân
德安德鲁=DeAndre
富尔茨=Fultz
乔某人=Kiều mỗ nhân
高天尊=Cao thiên tôn
大天尊=Đại thiên tôn
詹姆斯=James
雷迪克=Redick
西蒙斯=Simmons
恩比德=Embiid
罗纳多=La Nạp Đa
杜兰特=Đỗ Lan Đặc
拉索德=Lasode
多萝茜=Dorothy
安休斯=Anschutz
安克诺玛=Ankenoma
巴力尔=Baal
厄尔多=Erdo
伯利坦=Belitan
祝姑娘=Chúc cô nương
马明远=Mã Minh Viễn
尹尚子=Doãn Thượng Tử
梁少爷=Lương thiếu gia
陈四娘=Trần Tứ Nương
有川兄=Hữu Xuyên huynh
陈有川=Trần Hữu Xuyên
周轻云=Chu Khinh Vân
梁公子=Lương công tử
梁春秋=Lương Xuân Thu
梁子强=Lương Tử Cường
梁杨氏=Lương Dương thị
拉夫罗夫=Lavrov
马小姐=Mã tiểu thư
艾维琳娜=Evelina
杜子清=Đỗ Tử Thanh
拉米罗=Ramiro
诺阿金=Noakin
若阿金=Joaquin
马文秀=Mã Văn Tú
撒尼尔森=Sanilson
舒星度=Thư Tinh Độ
李舜圭=Lee Joon-gyu
赫尔丘利=Herculi
寒晚澜=Hàn Vãn Lan
权宁植=Kwon Nyeong-sik
雪狼王=Tuyết Lang Vương
聂施主=Niếp thí chủ
阿纳斯塔=Anasta
林佰广=Lâm Bách Quảng
马先生=Mã tiên sinh
露丝雅=Lucea
马所长=Mã sở trưởng
普拉多=Prado
阿尔蒂尔=Altir
孙太医=Tôn thái y
马努埃尔=Manuel
科瑞斯特尔=Kristel
科瑞斯=Coreys
法马凯里亚=Famacheria
孙京植=Sohn Kyung Shik
M霍兹=mhz
塞尔玛=Thelma
萨德尼=Sadney
瑟韦尔=Sewell
萨帕泰罗=Zapatero
贝尔戈斯=Bergos
特谢拉=Teixeira
卡西亚斯=Cassias
李高博=Lý Cao Bác
马尔迪莫斯=Maldimos
阿芙罗拉=Aphrola
鲁契亚娜=Luciana
阿尔蒂尓=Alti
萨尔盖罗=Salghero
玛佩尔=Mapel
罗巴切夫斯基=Lobachevsky
米里娜=Mirina
涅西卡=Nesica
列夫斯基=Levski
巴雷克=Barek
贝格纳=Begna
安诺尼斯=Anonis
陈当时=Trần Đương Thì
秦小倩=Tần Tiểu Thiến
谢东流=Tạ Đông Lưu
翟青枫=Địch Thanh Phong
蒋青冥=Tưởng Thanh Minh
舒纤云=Thư Tiêm Vân
翠颜翡=Thuý Nhan Phỉ
寒烟雨=Hàn Yên Vũ
寒倚风=Hàn Ỷ Phong
雨时归=Vũ Thời Quy
赵凤歌=Triệu Phượng Ca
亚瑟.霍克=Arthur Hawke
曲大哥=Khúc đại ca
烈风宗主=Liệt Phong tông chủ
丹涅尔=Deneir
精绝王=Tinh Tuyệt vương
茉莉轩=Jasmine Pavilion
熊首长=Hùng thủ trưởng
熊老爷=Hùng lão gia
辛东斌=Shin Dong-bin
王教谕=Vương giáo dụ
小金老师=tiểu Kim lão sư
胡五妹=Hồ Ngũ Muội
朱皇帝=Chu hoàng đế
刘大掌柜=Lưu chưởng quỹ lớn
林兄弟=Lâm huynh đệ
李广发=Lý Quảng Phát
张大疤啦=Trương Sẹo Lớn
张大疤拉=Trương Sẹo Lớn
许老师=Hứa lão sư
王仙芝=Vương Tiên Chi
哈泽斯=Hazes
菲利叶.桃乐丝=Filia Dorothy
菲利叶=Filia
科罗德=Corod
核爆灯会=hội đèn lồng Hạt Nhân Nổ Tung
斯卡恩=Skagen
布兰希特=Blanchit
徐兄弟=Từ anh em
安博拉=Ambola
黑旗老四=Hắc Kỳ lão tứ
索拉尔=Solar
胡胖子=Hồ mập mạp
熊文焕=Hùng Văn Hoán
熊文灿=Hùng Văn Xán
奥尔曼=Allman
汪总管=Uông tổng quản
索拉诺=Solano
马克沁=Maxim
林掌柜=Lâm chưởng quỹ
精绝国=Tinh Tuyệt quốc
杨少侠=Dương thiếu hiệp
高钦舜=Cao Khâm Thuấn
李金泉=Lý Kim Tuyền
柳静芳=Liễu Tĩnh Phương
马妮娜=Marnina
米达伦=Midalen
纽伦贝克=Nuremback
贝克曼=Beckmann
乌尔里希=Ulrich
纽伦贝=Nuremback
奥尔登堡=Oldenburg
雷尔夫=Ralph
克莱儿=Claire
施言嫣=Thi Ngôn Yên
梅克伦=Mekelen
乔瑟琳=Jocelyn
慕容兄=Mộ Dung huynh
墨白凤=Mặc Bạch Phượng
孙承业=Tôn Thừa Nghiệp
陈忘生=Trần Vong Sinh
童倾眉=Đồng Khuynh Mi
金哲驰=Kim Triết Trì
炼天君=Luyện Thiên Quân
张兴培=Trương Hưng Bồi
许哥哥=Hứa ca ca
胡承龙=Hồ Thừa Long
万鬼老祖=Vạn Quỷ Lão Tổ
柯先生=Kha tiên sinh
金雀花=Broom
惠源哀=Huệ Nguyên Ai
柯仲玉=Kha Trọng Ngọc
·范·=· Fan ·
博拉克=Borak
马林堡=Marienburg
许大侠=Hứa đại hiệp
赫罗托斯=Hortos
殇无念=Thương Vô Niệm
念无殇=Niệm Vô Thương
七杀断肠=Thất Sát Đoạn Trường
芬克斯=Finks
阿斯卡=Aska
甄友乾=Chân Hữu Càn
何筱年=Hà Tiêu Niên
赫尔格斯=Helges
徐婉秀=Từ Uyển Tú
狮身人面的怪物=Sphinx
狮身人面=Sphinx
迪亚克=Diack
拉夏尔=Lachar
拉德斯=Rades
沈公子=Thẩm công tử
拉格特=Laguet
劳艾尔=Lauer
风长老=Phong trưởng lão
风疏月=Phong Sơ Nguyệt
厉若空=Lệ Nhược Không
厉长老=Lệ trưởng lão
叶宗主=Diệp tông chủ
阴婉华=Âm Uyển Hoa
米哈利克=Mihalik
克利哈米=Klihami
于大哥=Vu đại ca
田在中=Điền Tại Trung
露维娅=Luvia
田长老=Điền trưởng lão
于明之=Vu Minh Chi
李长老=Lý trưởng lão
伊迪斯=Edith
安娜特=Annette
张灵羽=Trương Linh Vũ
聂止禾=Niếp Chỉ Hoà
露薏莎=Louisa
多洛茜=Dorothy
李三光=Lý Tam Quang
蜜尔娜=Mirna
奎金斯=Quiggins
曹督主=Tào đốc chủ
韦尔斯=Wells
曲无忧=Khúc Vô Ưu
瑟克塞斯=Success
扎拉斯文=Zarathian
徐梓画=Từ Tử Hoạ
杨子伟=Dương Tử Vĩ
罗拉克斯=Lorax
赵无欲=Triệu Vô Dục
厄尔克斯=Erkes
聂方元=Niếp Phương Nguyên
亨廷顿=Huntington
西门雪=Tây Môn Tuyết
瓦伦特=Valente
圣德兰=St.Derain
拉索娅=Lazoya
吴小穷=Ngô Tiểu Cùng
叶青玄=Diệp Thanh Huyền
吴蕴初=Ngô Uẩn Sơ
金喜珊=Kim Hỉ San
勋素鸡=Huân Tố Gà
香格拉=Shangra
小玥儿=Tiểu Nguyệt Nhi
吴此仁=Ngô Thử Nhân
孟晓东=Mạnh Hiểu Đông
孟兄弟=Mạnh huynh đệ
美什凯特=Meskat
埃特纳=Etna
摩洛斯=Moros
弗伦堡=Fremberg
费尔提斯=Fertis
尤里斯塞=Urissay
裴圣子=Bùi thánh tử
齐拉格=Zirag
山田花太郎=Hanatarō Yamada
山田清之介=Seinosuke Yamada
佐佐木三郎=Sasaki Saburo
卯之花烈=Unohana Retsu
纲弥代=Tsunayashiro
卯之花=Unohana
纲弥代岩=Tokinada Tsunayashiro
阿散井=Abarai
吉良伊鹤=Izuru Kira
桧佐木=Hisagi
桧佐木修兵=Shūhei Hisagi
蟹泽萤=Hotaru Kanisawa
第五十三位=thưa 53
安格乌斯=Angus
塞罗德=Serrod
菲尔贝尔=Philbel
艾斯提拉=Estilla
艾扎洛=Aizalo
安德拉德=Andrade
阿特兰特=Atlante
霍尔特=Holt
康格斯=Conges
阿比达尔=Abidal
极野家=Cực Dã Gia
许方舟=Hứa Phương Chu
冯·米勒=Von · Miller
阿达尔贝特=Adalbert
库克斯=Cooks
白无神=Bạch Vô Thần
徐莽生=Từ Mãng Sinh
白石安=Bạch Thạch An
李高阳=Lý Cao Dương
李羽白=Lý Vũ Bạch
徐莽元=Từ Mãng Nguyên
朱世容=Chu Thế Dung
花宛如=Hoa Uyển Như
陈宽厚=Trần Khoan Hậu
莫委员=Mạc uỷ viên
勋素济=Huân Tố Tế
海述祖=Hải Thuật Tổ
陈忠焕=Trần Trung Hoán
斯内壳=Tư Nội Xác
吴大用=Ngô Đại Dụng
万首长=Vạn thủ trưởng
座山雕=Toạ Sơn Điêu
符一金=Phù Nhất Kim
符二银=Phù Nhị Ngân
符不大=Phù Không Lớn
李铁匠=Lý thợ rèn
刘友仁=Lưu Hữu Nhân
极长老=Cực trưởng lão
赵辰星=Triệu Thần Tinh
卢夫人=Lư phu nhân
施大哥=Thi đại ca
许心素=Hứa Tâm Tố
齐老大=Tề lão đại
沃尔夫堡=Wolfsburg
佩福斯=Paphos
bruce=Bruce
阿西卡娜=Asikana
由掌柜=Từ chưởng quỹ
林嫦曦=Lâm Thường Hi
柯大哥=Kha đại ca
金由衣=Kim Do Y
毛阿兰=Mao A Lan
胡仁山=Hồ Nhân Sơn
龙施主=Long thí chủ
郭同志=đồng chí Quách
步姐姐=Bộ tỷ tỷ
特里奥斯=Trios
尤杜拉=Udula
叶有道=Lá Hữu Đạo
龙先生=Long tiên sinh
奥菲莉亚=Ophelia
卡瑞娜=Karina
金滉植=Kim Hwang-sik
郑梦准=Chung Mong-joon
朴元淳=Park Won-soon
安哲秀=Ahn Cheol-soo
狮身人面兽=Sphinx
艾柯丝=Alice
摘星楼主=Trích Tinh Lâu Chủ
小日本=Nhật lùn
李施主=Lý thí chủ
龙殿主=Long điện chủ
刘长老=Lưu trưởng lão
林师侄=Lâm sư điệt
韩师弟=Hàn sư đệ
韩师侄=Hàn sư điệt
斯塔尼斯=Stanis
聂师弟=Niếp sư đệ
张师弟=Trương sư đệ
段师弟=Đoàn sư đệ
紫虚师叔=Tím Hư sư thúc
张道姑=Trương đạo cô
尹夏林=Yoon Ha-rim
郑秀晶=Jung Soo-jung
金恩淑=Kim Eun-sook
李老哥=Lý lão ca
小灵儿=Tiểu Linh Nhi
紫虚师兄=Tử Hư sư huynh
张师姐=Trương sư tỷ
林道寒=Lâm Đạo Hàn
杜磊司=Đỗ Lỗi Ty
纪德原=Kỷ Đức Nguyên
陆少侠=Lục thiếu hiệp
陆三友=Lục Tam Hữu
叶师兄=Diệp sư huynh
西门兄=Tây Môn huynh
叶道长=Diệp đạo trưởng
紫玉师兄=Tử Ngọc sư huynh
小玄子=Tiểu Huyền Tử
徐老哥=Từ lão ca
任老哥=Nhậm lão ca
徐大哥=Từ đại ca
徐庆元=Từ Khánh Nguyên
卢西亚=Lucia
尹昊苍=Doãn Hạo Thương
法布里尼=Fabrini
德沃夏克=Dvořák
马萨瓦=Massawa
西里修斯=Sirius
格利高里=Gregorian
安勒斯特=Anrest
安勒斯=Anles
格利高=Gregor
万里煌=Vạn Lý Hoàng
陈八尺=Trần Bát Xích
叶八尺=Diệp Bát Xích
叶会长=hội trưởng Diệp
希姆莱=Himmler
单道谦=Đơn Đạo Khiêm
古长老=Cổ trưởng lão
高教导员=chính trị viên Cao
林船长=thuyền trưởng Lâm
李凝玉=Lý Ngưng Ngọc
莫长老=Mạc trưởng lão
洛特尼科夫=Lotnikov
任小芹=Nhậm Tiểu Cần
尼科诺夫=Nikonov
彼得洛夫=Petrov
费多罗夫=Fedorov
基诺夫=Kinov
马特维=Matvi
伊万诺夫斯基=Ivanovsky
卡莲莉娜=Karina
米亚卡=Miaka
尼亚克=Niak
鲍尔沙克=Balsak
洛特尼克夫=Lotnikoff
洛特尼克娃=Lotnikova
卡莉莲娜=Kalliana
别尔夫=Belv
雷亚尔=Real
瓦连京=Valentin
沙赫兰=Shahran
明塔克=Mintak
阿弗瑞斯=Avris
莫堂主=Mạc đường chủ
苏李二人=Tô Lý hai người
曹公公=Tào công công
李同学=Lý đồng học
苏同学=Tô đồng học
何小丫=Hà Tiểu Nha
叶姐姐=Diệp tỷ tỷ
殊十二=Thù Thập Nhị
周帝白洛=Chu Đế Bạch Lạc
赵无极=Triệu Vô Cực
西门御=Tây Môn Ngự
李奈何=Lý Nại Hà
晋王白玉=Tấn Vương Bạch Ngọc
太子白羽=thái tử Bạch Vũ
零零妖=Linh Linh Yêu
零零玖=Không Không Chín
零零肆=Không Không Bốn
零零偲=Linh Linh Tai
郦贵妃=Ly quý phi
诸葛武侯=Gia Cát Võ Hầu
贝尔特朗=Bertrand
尤里斯安=Yurisian
吴少侠=Ngô thiếu hiệp
刘建明=Lưu Kiến Minh
刘君玄=lưu Quân Huyền
斯特鲁曼=Struman
金光佛=Kim Quang Phật
梅内塞斯=Menezes
奥雷里奥=Aurelio
欧阳二狗=Âu Dương Nhị Cẩu
门沙克=Mensak
卡内罗=Carneiro
小白姑娘=Tiểu Bạch cô nương
黄泉魔女=Hoàng Tuyền Ma Nữ
活杀留声=Hoạt Sát Lưu Thanh
特拉奎尔=Traquel
巴哈欧拉=Bahá'u'lláh
本笃二世=Benedict đệ nhị
瓦伦希尔=Valenhill
穆风华=Mục Phong Hoa
燕余休=Yến Dư Hưu
姜夫人=Khương phu nhân
于里安=Yulian
泰奥多尔=Théodore
埃克西里昂=Exirion
艾勒丝汀=Allerstein
薇尔尼娅=Vernia
李姑娘=Lý cô nương
烈风大人=Liệt Phong đại nhân
黄庄主=Hoàng trang chủ
烈风兄=Liệt Phong huynh
菲力贝尔=Philiber
妖异公子=Yêu Dị Công Tử
墨心白莲=Mặc Tâm Bạch Liên
周倚天=Chu Ỷ Thiên
阿松桑=Asuncion
谢晓彬=Tạ Hiểu Bân
齐德尔曼=Zidelman
阿瑟·道尔=Arthur · Doyle
萨里瓦=Sariva
叶雨时=Diệp Vũ Thời
鲁伊兹=Ruiz
罗德姆=Rodham
白莲剑仙=Bạch Liên Kiếm Tiên
吴永仁=Ngô Vĩnh Nhân
弗洛罗莎=Florosa
黄少庄主=Hoàng thiếu trang chủ
弗洛伦莎=Florence
苏沐橙=Tô Mộc Tranh
柏丽尔=Beryl
德鲁蒙德=Drummond
白姑娘=Bạch cô nương
拉瓦那=Ravana
科斯塔=Khoa Tư Tháp
莉迪娅=Lydia
洛克林妮=Locklinie
奥东科=Odonko
利安德鲁=Leandrew
伊格纳=Igna
阿道尔=Ador
蒂娜迪莫斯=Tina Dimos
奥弗里=Offry
佩索尔=Pesol
肖小宇=Tiêu Tiểu Vũ
陈大柱=Trần Đại Trụ
贝亚特=Beate
伊内斯=Ines
薇尔尼雅=Vernia
尤利斯=Ulis
拉文第=Lavendi
瓦西姆=Wasim
奥尔堡=Aalborg
劳薇特=Lauvet
萨科奇=Sarkozy
奥朗德=Hollande
加菲尔德=Garfield
西梅翁=Simeon
普洛斯佩尔=Prosper
叶良辰=Diệp Lương Thần
林姑娘=Lâm cô nương
安博拉法=Ambola
西恩六雄=Tây Ân Lục Hùng
催命判官=Thôi Mệnh Phán Quan
孙大哥=Tôn đại ca
拉扎尔=Lazar
帕德雷=Padre
德布尔=Debour
周荣明=Chu Vinh Minh
阿纳德=Arnold
苏宗主=Tô tông chủ
加斯帕尔=Gaspar
费罗娜=Ferona
蒙卡罗=Moncaro
巴力斯塔=Ballista
雅洛蓝=Nhã Lạc Lam
卡特丽娜=Catharina
奥尔莫斯=Olmos
斯普林特=Sprint
蕾依丽雅=Leo Liya
安尼克=Annick
默西迪丝=Mercedes
阿斯塔尔=Astar
杰洛士=Gerlos
奥利耶夫=Oliev
乌塔卡=Utaka
格兰尼夫=Granif
米契尔=Mitchell
蒙卡奇=Moncachi
布里亚纳=Briana
柯莱特=Camelot
古斯特=Gust
格兰纽夫=Granuve
维森特=Vincente
克里夫兰=Cleveland
尤利塞斯=Ulysses
哈斯米尔=Hasmere
阿莫雷丘克=Amorechuk
劳伦斯·梅斯菲尔德=Lawrence Macefield
塔西娅·路易=Tasia Louis
李俊益=Lee Joon-ik
朴勋政=Park Hoon-jung
李浩扬=Lee Ho-yang
李秉喆=Lee Byung-chul
陈近南=Trần Cận Nam
马关长=trưởng quan Mã
连刘三=kể cả Lưu Tam
杜盛兴=Đỗ Thịnh Hưng
马神父=cha xứ Mã
朱八八=Chu Bát Bát
斯威夫特=Swift
包伯青=Bao Bá Thanh
陆若汉=Lục Nhược Hán
汤神父=cha xứ Thang
王尊徳=Vương Tôn Đức
孙学诗=Tôn Học Thi
马阳春=Mã Dương Xuân
夸克穷=Quack Nghèo
袁督师=Viên đốc sư
袁崇焕=Viên Sùng Hoán
廖厨子=đầu bếp Liêu
蒋姨太=Tưởng di thái
顾葆成=Cố Bảo Thành
程掌柜=Trình chưởng quỹ
夸克.穷=Quack. Nghèo
john.quark=John Quark
杨大掌柜=Dương chưởng quỹ lớn
李老爷=Lý lão gia
林百户=Lâm bách hộ
林夫人=Lâm phu nhân
刘百户=Lưu bách hộ
黄兄弟=người anh em Hoàng
杨世意=Dương Thế Ý
五老爷=ngũ lão gia
刘掌柜=Lưu chưởng quỹ
蝗太极=Hoàng Thái Cực
李叔叔=chú Lý
黄首长=thủ trưởng Hoàng
黄掌柜=chưởng quỹ Hoàng
杨老爷=Dương lão gia
乌云花=Ô Vân Hoa
山西帮=Sơn Tây bang
刘管事=Lưu quản sự
哈贝罗=Habero
林老爷=Lâm lão gia
刘大夫=bác sĩ Lưu
刘本善=Lưu Bản Thiện
刘先生=Lưu tiên sinh
杨掌柜=Dương chưởng quỹ
安非他命=Amphetamine
纽维尔=Newville
奥莉芙·霍克=Olive Hawke
梅瑞狄斯=Meredith
乔治二世=George II
乔治一世=George I
阿普西斯=Apsis
霍芬伯格=Hoffenberg
阿纳托尔=Anatole
沃恩斯=Vones
提弗蒂迪斯=Tiffidis
沙门氏=samonella
蒂尔朵=Tildo
波希特=Pocht
亚卡夏=Yakasia
怀恩骑士=Wyan kỵ sĩ
海华德=Hayward
史尼亚=Snia
时部长=bộ trưởng Thời
马斯基林=Maschinen
沃尔多=Waldo
谢特里昂=Chetlyon
路冰娫=Đường Băng Vân
白竹雨=Bạch Trúc Vũ
蛸·八爪=Sao · Bát Trảo
罗杰里奥=Rogerio
莱斯利=Leslie
斯图尔克=Sturk
格瑞丝=Grace
格瑞丝将=Grace Will
皮奥拉=Piola
李海丽=Lee Hae-ri
塔诺斯=Thanos
的李海丽=Lee Hae-ri
G大调小夜曲=Serenade in G major
德罗尼=Deloni
方永逸=Phương Vĩnh Dật
张正诚=Trương Chính Thành
费朗索瓦=Francois
克莱芒=Clermont
伊依依=Y Y Y
赛赫尔=Sechel
帕赫贝尔=Pachelbel
芳草地=đất cỏ thơm
打磨工=công nhân mài dũa
持典者=Holder
哥赛特=Cosette
阿莫顿=Amerton
德拉甘=Dragan
于尔班=Urban
于尓班=Urban
西尔维亚=Sylvia
白手套=Bao Tay Trắng
白蜜糖=White Honey
‘教授’=‘The Godfather’
胡青白=Hồ Thanh Bạch
符悟本=Phù Ngộ Bản
白老师=lão sư Bạch
符四男=Phù Tứ Nam
白石禄=Bạch Thạch Lộc
吴石芒=Ngô Thạch Mang
终葵铿=Chung Quỳ Khanh
杜拂旌=Đỗ Phất Tinh
苗若生=Miêu Nhược Sinh
文徳嗣=Văn Đức Tự
太上护法=Thái Thượng hộ pháp
杜队长=đội trưởng Đỗ
刘队长=đội trưởng Lưu
剿匪队=đội diệt cướp
赵海谐=Triệu Hải Hài
梅老头=Mai lão nhân
裴真传=Bùi chân truyền
梅老太太=Mai lão thái thái
张善允=Jang Sun-yoon
梅老太婆=Mai lão thái bà
梅老婆子=Mai lão bà tử
赵海基=Triệu Hải Cơ
忻四爷=Hãn tứ gia
赵大爷=Triệu đại gia
王五术=Vương Ngũ Thuật
楚仙子=Sở tiên tử
嵇玉浮=Kê Ngọc Phù
闻人蘼=Văn Nhân Mi
终葵止棘=Chung Quỳ Chỉ Cức
秋未央=Thu Vị Ương
楚羽裳=Sở Vũ Thường
商扶风=Thương Phù Phong
任濯鳞=Nhiệm Trạc Lân
寂昭子=Tịch Chiêu Tử
燕犀城=Yến Tê Thành
苏贤弟=Tô hiền đệ
司鸿澜=Tư Hồng Lan
厉无咎=Lệ Vô Cữu
苏离经=Tô Cách Kinh
无寐兄=Vô Mị huynh
无定兄=Vô Định huynh
司鸿烟韶=Tư Hồng Yên thiều
厉无定=Lệ Vô Định
苏映涯=Tô Ánh Nhai
苏千涯=Tô Thiên Nhai
司鸿妙璃=Tư Hồng Diệu Ly
司鸿倾嬿=Tư Hồng Khuynh Yến
乔师妹=Kiều sư muội
晏明婳=Yến Minh Hoạ
嵇长浮=Kê Trường Phù
宁无夜=Ninh Vô Dạ
终葵越棘=Chung Quỳ Việt Cức
莫师妹=Mạc sư muội
钟师姐=Chung sư tỷ
楚师姐=Sở sư tỷ
刘大柱=Lưu Đại Trụ
赵大冲=Triệu Đại Xung
忻那春=Hãn Na Xuân
杜首长=thủ trưởng Đỗ
忻大爷=Hãn đại gia
周寡妇=Chu quả phụ
符大伯=bác cả Phù
陆神父=cha xứ Lục
吴太爷=Ngô thái gia
党大爷=Đảng đại gia
赵海清=Triệu Hải Thanh
党老大=Đảng lão đại
章师姐=Chương sư tỷ
章仙子=Chương tiên tử
康真传=Khang chân truyền
肖季涛=Tiếu Quý Đào
忻那日=Hãn Na Nhật
党那门=Đảng Na Môn
党国栋=Đảng Quốc Đống
乔师姐=Kiều sư tỷ
钟诗珠=Chung Thi Châu
楚含蓓=Sở Hàm Bội
温惜雪=Ôn Tích Tuyết
温惜晴=Ôn Tích Tình
肖伯涛=Tiếu Bá Đào
终葵子黎=Chung Quỳ Tử Lê
章灵馨=Chương Linh Hinh
贝尔修伦=Belthuron
诺尔曼=Norman
肖叔涛=Tiếu Thúc Đào
乔仙子=Kiều tiên tử
肖氏四老=Tiếu Thị Tứ Lão
卧丘老祖=Ngoạ Khâu lão tổ
羽濛仙子=Vũ Mông tiên tử
杨大夫=bác sĩ Dương
任佑宰=Lim Woo-jae
柳紫绵=Liễu Tử Miên
康少胤=Khang Thiếu Dận
裴公子=Bùi công tử
胡仪成=Hồ Nghi Thành
时院长=Thì viện trưởng
赵艳梅=Triệu Diễm Mai
河大夫=bác sĩ Hà
厉圣女=Lệ thánh nữ
陈亚保=Trần Á Bảo
中医药=thuốc đông y
席胖子=Tịch mập mạp
兰阳阳=Lan Dương Dương
侯闻永=Hầu Văn Vĩnh
时袅仞=Thời Niểu Nhận
金塔勒=kim Tal
药清罂=Dược Thanh Anh
药夜舒=Dược Dạ Thư
终葵采蘩=Chung Quỳ Thái Phiền
绝心仙尊=Tuyệt Tâm Tiên Tôn
琉婪皇帝=Lưu Lam hoàng đế
梦晦老魔=Mộng Hối Lão Ma
查理一世=Charles đệ nhất
安舞缤=An Vũ Tân
米老板=Mễ lão bản
药海棠=Dược Hải Đường
药辛夷=Dược Tân Di
药茉莉=Dược Mạt Lỵ
药合欢=Dược Hợp Hoan
药朝颜=Dược Triều Nhan
朱供奉=Chu cung phụng
斯里普=Slip
莫夫人=Mạc phu nhân
王道友=Vương đạo bạn
秋雁书=Thu Nhạn Thư
终葵晞=Chung Quỳ Hi
明爽俊=Minh Sảng Tuấn
南宫粟=Nam Cung Túc
任太熙=Yim Tae-hee
西恩·伊文斯=Sean Evans
李允馨=Lee Yoon-hyung
鹿雷霆=Lộc Lôi Đình
叶满月=Diệp Mãn Nguyệt
康承挚=Khang Thừa Chí
李富真=Lee Boo-jin
吴掌柜=Ngô chưởng quỹ
莫洛托夫=Molotov
北首长=thủ trưởng Bắc
许营捷=Hứa Doanh Tiệp
徳林杰=Delinger
季端言=Quý Đoan Ngôn
水致霂=Thuỷ Trí Mộc
常师徳=Thường Sư Đức
鹿冰芸=Lộc Băng Vân
荀无恙=Tuân Vô Dạng
樊橘颂=Phàn Quất Tụng
樊德昌=Phàn Đức Xương
王大春=Vương Đại Xuân
李大春=Lý Đại Xuân
北同志=đồng chí Bắc
李丝俗=Lý Ti Tục
司鸿仑山=Ty Hồng Luân Sơn
仑山前辈=Luân Sơn tiền bối
刘玉林=Lưu Ngọc Lâm
冯老板=Phùng ông chủ
冯掌柜=Phùng chưởng quỹ
颜琴琅=Nhan Cầm Lang
尉迟克玿=Uất Trì Khắc Chiểu
薛如琰=Tiết Như Diễm
辛余寒=Tân Dư Hàn
何无复=Hà Vô Phục
贺竹志=Hạ Trúc Chí
顾南薰=Cố Nam Huân
药仙女=Dược Tiên Nữ
厉前辈=Lệ tiền bối
皇甫无尘=Hoàng Phủ Vô Trần
陆东信=Lục Đông Tín
苏醉绮=Tô Tuý Khởi
小伊文斯=tiểu Evans
绝心子=Tuyệt Tâm Tử
石万里=Thạch Vạn Lý
王大师=Vương đại sư
乔慈光=Kiều Từ Quang
石楼主=Thạch lâu chủ
十二巫=Thập Nhị Vu
老乔尔=lão Joel
许淑蓉=Hứa Thục Dung
莫少鳌=Mạc Thiếu Ngao
梅·琼斯=Mai Jones
惠瑶姬=Huệ Dao Cơ
宜音仙子=Nghi Âm tiên tử
莫师姐=Mạc sư tỷ
昆羽老怪=Côn Vũ Lão Quái
莫澧兰=Mạc Lễ Lan
计乘龙=Kế Thừa Long
曹萃萝=Tào Tuỵ La
冯广丰=Phùng Quảng Phong
白求恩=Norman Bethune
黑铁城=Hắc Thiết thành
苗师兄=Miêu sư huynh
波克兰=Poquelin
苗师弟=Miêu sư đệ
马三强=Mã Tam Cường
林大哥=Lâm đại ca
谌掌柜=Thẩm Chưởng Quỹ
塔西娅=Tasia
文在寅=Moon Jae-in
谌老爷=Kham lão gia
林师傅=Lâm sư phụ
燕然哥=Yến Nhiên Ca
小金秀=Tiểu Kim Tú
厉无寐=Lệ Vô Mị
朱老板=Chu lão bản
司鸿航=Ty Hồng Hàng
萧酸子=Tiêu Toan Tử
健次郎=Kenjiro
北掌柜=Bắc chưởng quỹ
李胜基=Lee Seung-gi
弗朗茨=Franz
克莉丝·温彻=Kris Winchester
寇三郎=Khấu Tam Lang
厉燕陵=Lệ Yến Lăng
桑前辈=Tang tiền bối
紫梅老祖=Tử Mai lão tổ
桑夫人=Tang phu nhân
齐玉郎=Tề Ngọc Lang
计霜儿=Kế Sương Nhi
都老爷=Đô lão gia
计有忠=Kế Hữu Trung
董季重=Đổng Quý Trọng
洪河钟=Hong Ha-jong
吴芝香=Ngô Chi Hương
新沙洞=Shinsadong
剑一天=Kiếm Nhất Thiên
南宫赢=Nam Cung Doanh
厉燕然=Lệ Yến Nhiên
厉寒歌=Lệ Hàn Ca
月姐姐=Nguyệt tỷ tỷ
洪瑜暻=Hong Yoo-kyung
何山光=Hà Sơn Quang
监察殿主=Giám Sát điện chủ
梅老家主=Mai lão gia chủ
古大春=Cổ Đại Xuân
六姨太=Lục di thái
霍召景=Hoắc Triệu Cảnh
耕种之神=Thần Trồng Trọt
淳于康=Thuần Vu Khang
吕燕泥=Lã Yến Nê
克丽丝=Kris
魔法师团=ma pháp sư đoàn
加文·沃伦=Gavin Warren
伊达·坎贝尔=Ed Campbell
梅可秋=Mai Khả Thu
裴脉主=Bùi mạch chủ
戴白时=Đái Bạch Thời
严玉鸣=Nghiêm Ngọc Minh
歌礼·埃奇沃思=Kerry Edgeworth
王大胡子=Vương Râu Ria
邬委员=uỷ viên Ổ
马总长=tổng tham mưu trưởng Mã
理查德·梅斯菲尔德=Richard Macefield
索菲亚·帕特里克=Sofia Patrick
周师姐=Chu sư tỷ
苏师兄=Tô sư huynh
苏震禾=Tô Chấn Hoà
金姑娘=Kim cô nương
苏真传=Tô chân truyền
常东家=Thường ông chủ
杭子轩=Hàng Tử Hiên
朱师兄=Chu sư huynh
武玉甲=Võ Ngọc Giáp
朱师弟=Chu sư đệ
史云田=Sử Vân Điền
玉雪照=Ngọc Tuyết Chiếu
大疤拉=Sẹo Lớn Kéo
廖大兴=Liệu Đại Hưng
丁海流=Đinh Hải Lưu
阮簇簇=Nguyễn Thốc Thốc
赵一毅=Triệu Nhất Nghị
维恩·温彻=Wien Winchester
艾略特·温彻=Eliot Winchester
卢师兄=Lư sư huynh
尔朱崆=Nhĩ Chu Không
叶子诚=Diệp Tử Thành
周妙璃=Chu Diệu Ly
达奚瓒=Đạt Hề Toản
莫振衣=Mạc Chấn Y
厉师姐=Lệ sư tỷ
金素眠金师姐=Kim Tố Miên Kim sư tỷ
金脉主=Kim mạch chủ
钟玉生=Chung Ngọc Sinh
赵天籁=Triệu Thiên Lại
宣轻轻=Tuyên Khinh Khinh
公治言=Công Trị Ngôn
厉猎月=Lệ Liệp Nguyệt
钱文楚=Tiền Văn Sở
裴师兄=Bùi sư huynh
田从横=Điền Tòng Hoành
姜执事=Khương chấp sự
圣洛恩=Saint Lorne
西门的伪君子=nguỵ quân tử họ Tây Môn
韩思古韩师兄=Hàn Tư Cổ Hàn sư huynh
血夫人=Huyết Phu Nhân
董师姐=Đổng sư tỷ
安魂丹=An Hồn Đan
陆师弟=Lục sư đệ
李健熙=Lee Kun-hee
陆师兄=Lục sư huynh
安师妹=An sư muội
董采薇=Đổng Thái Vi
董师妹=Đổng sư muội
焦师兄=Tiêu sư huynh
姜师妹=Khương sư muội
陆复江=Lục Phục Giang
唐师兄=Đường sư huynh
周师弟=Chu sư đệ
管师姐=Quản sư tỷ
管师妹=Quản sư muội
焦师弟=Tiêu sư đệ
唐南斋=Đường Nam Trai
王师姐=Vương sư tỷ
埃里克·冯=Eric Von
李师姐=Lý sư tỷ
艾希薇尔=Ashwell
葛师弟=Cát sư đệ
白师兄=Bạch sư huynh
贺师兄=Hạ sư huynh
克莉丝=Kris
韩思古=Hàn Tư Cổ
韩师兄=Hàn sư huynh
王姣娘=Vương Giảo Nương
李霞卿=Lý Hà Khanh
周乘风=Chu Thừa Phong
赵昌安=Triệu Hưng An
冷师弟=Lãnh sư đệ
鲁师姐=Lỗ sư tỷ
李师妹=Lý sư muội
徐师弟=Từ sư đệ
管雪蕊=Quản Tuyết Nhuỵ
鲁师妹=Lỗ sư muội
赵鸡脚=Triệu Kê Cước
金素台=Kim Tố Đài
祝三爷=Chúc Tam Gia
廖掌柜=Liêu chưởng quỹ
李师兄=Lý sư huynh
鬼柳峰=Quỷ Liễu Phong
钟博士=tiến sĩ Chung
盎格鲁－撒克逊=Anglo — Saxon
盎格鲁=Anglo
撒克逊=Saxon
殷东蒙=Ân Đông Mông
欧阳纤梦=Âu Dương Tiêm Mộng
墨元白=Mặc Nguyên Bạch
苗脉主=Miêu mạch chủ
周真传=Chu chân truyện
沈先生=Thẩm tiên sinh
车永长=Xa Vĩnh Trường
钱、朱=Tiền, Chu
蝉息术=Ve tức thuật
墨小姐=Mặc tiểu thư
王督师=Vương đốc sư
欧阳纤星=Âu Dương Tiêm Tinh
宫野优子=Miyano Yuko
朴安真=Park An Jin
钱长君=Tiền Trường Quân
朱子尤=Chu Tử Vưu
鲁绿蔷=Lỗ Lục Sắc
金道友=Kim đạo hữu
邵宁直=Thiệu Ninh Trực
金师妹=Kim sư muội
金素眠=Kim Tố Miên
苗成阳=Miêu Thành Dương
厉真传=Lệ chân truyền
端木明烟=Đoan Mộc Minh Yên
端木炎=Đoan Mộc Viêm
裴小友=Bùi tiểu hữu
萧师妹=Tiêu sư muội
端木城主=Đoan Mộc thành chủ
张师兄=Trương sư huynh
萧师姐=Tiêu sư tỷ
裴仙师=Bùi tiên sư
裴师弟=Bùi sư đệ
张仲禽=Trương Trọng Cầm
萧踏莎=Tiêu Đạp Toa
顾少校=Cố thiếu tá
顾思远=Cố Tư Viễn
陈师兄=Trần sư huynh
一李屏=Một Lý Bình
苗成安=Miêu Thành An
李思广=Lý Tư Quảng
孙映兰=Tôn Ánh Lan
赵大正=Triệu Đại Chính
金斗汉=Kim Du-han
金乙京=Kim Eul-dong
宋一国=Song Il-kook
蒙博托=Mobutu
修伽佛子=Tu Già Phật Tử
奥斯卡森=Oskarsson
米兰达=Miranda
格域使=cách vực sứ
寒武纪=Kỷ Cambrian
杰尔斯=Giles
聂昌海=Niếp Xương Hải
素真天=Tố Chân Thiên
无始山庄=Vô Thuỷ sơn trang
墨大小姐=Mặc đại tiểu thư
徐仁国=Seo In-guk
珍妮·布劳恩=Jenny · Browne
布劳恩=Browne
雷斯诺=Resno
柳纤云=Liễu Tiêm Vân
天阴教又=Thiên Âm Giáo Hựu
孟诗雨=Mạnh Thi Vũ
秦若梦=Tần Nhược Mộng
欧阳景=Âu Dương Cảnh
斯蒂芬妮=Stephany
佐格尔=Zoger
恩斯特=Ernst
赵平海=Triệu Bình Hải
海林顿=Harrington
常首长=thủ trưởng Thường
布拉顿=Brattain
阿伦佐=Alonzo
柳凝霜=Liễu Ngưng Sương
孙管家=Tôn quản gia
孙大管家=Tôn đại quản gia
小倩倩=tiểu Thiến Thiến
天生教=Thiên Sinh giáo
托尼·帕克=Tony · Park
戴维·劳伦斯=David · Lawrence
卡特琳娜=Katerina
费尔南多=Fernando
巴金斯=Baggins
蕾切尔·康纳=Rachel · Connor
雅科夫=Yakov
老大伊万=lão đại Ivan
波塔斯基兄弟=Potaski huynh đệ
安吉丽娜·劳伦斯=Angelina · Lawrence
蕾切尔=Rachel
费蕾莎=Phí Nụ Toa
蒙比亚=Montbia
杨小姐=Dương tiểu thư
柯琳娜=Corinna
海因西里=Heinsley
万克米尔佘=Wankemilshe
沙姆巴拉=Shambala
克劳泽=Krause
麦克尼尔?瑟玛普拉格=Mekgineer Thermaplugg
费雷莎=Phí Lôi Toa
塞弗耳=Sever
噶尔洛夫卡=Galovka
平海岩=Bình Biển Nham
李老师=Lý lão sư
廖大化=Liệu Đại Hoá
常师爷=Thường sư gia
冯阳子=Phùng Dương Tử
小络络=Tiểu Lạc Lạc
墨水性=Mặc Thuỷ Tâm
莫裳蜓=Mạc Thường Duyên
莫裳娗=Mạc Thường Duyên
万克米尔舍=Wankemilshe
萨哈雅库特=Sahayakut
克拉斯罗亚尔斯=Krasnoyarsk
谢尔列维奇=Shelevitch
奥斯尔顿=Auston
范志中=Phạm Chí Trung
李沉铭=Lý Trầm Minh
李铭沉=Lý Minh Trầm
甘子强=Cam Tử Cường
阿基拉=Akila
苏清浅=Tô Thanh Thiển
田维代=Điền Duy Đại
绯红武神=Phi Hồng võ thần
索菲娜=Sophina
科瑞迪=Creedy
泰莉娜=Teleena
赫米特?奈辛瓦里=Hemet Nesingwary
赫米特=Hemet
奈辛瓦里=Nesingwary
安威玛尔=Anvilmar
艾斯特=Esther
清虚子=Thanh Hư Tử
神崎俊安=Thần Khi Tuấn An
花如儿=Hoa Như Nhi
洛暗天=Lạc Ám Thiên
小常子=tiểu Thường tử
赵勤言=Triệu Cần Ngôn
严小姐=Nghiêm tiểu thư
郭东主=Quách đông chủ
临高粮油总公司=Lâm Cao lương thực dầu mỡ tổng công ty
陈师傅=Trần sư phó
瑠美子=Rumiko
高师傅=Cao sư phó
周元希=Chu Nguyên Hi
陈百笑=Trần Bách Tiếu
索莉多米=Soridormi
阿纳克洛斯=Anachronos
诺滋多姆=Nozdormu
龙婆婆=Long bà bà
克罗米莉=Cromillie
一城红衣=Nhất Thành Hồng Y
邱领洁=Khâu Lĩnh Khiết
班德列=Bundrick
比迦耶=Tỉ Ca Gia
原先生=Nguyên tiên sinh
唐绯红=Đường Phi Hồng
杨絮竟=Dương Nhứ Cánh
关晓莲=Quan Hiểu Liên
肖仙子=Tiêu tiên tử
肖乐乐=Tiếu Nhạc nhạc
怒罗汉=Nộ La Hán
权正阳=Kwon Jung-yang
胡老爷=Hồ lão gia
石进喜=Thạch Tiến Hỉ
塔斯马尼亚=Tasmania
王掌柜=Vương chưởng quỹ
王进喜=Vương Vào Mừng
王首长=Vương thủ trưởng
王德纲=Vương Đức Cương
沈跃风=Thẩm Dược Phong
江秋堰=Giang Thu Yển
澹庵先生=Đạm Am tiên sinh
王活计=Vương hoạt kế
黎巴雅=Lê ba nhã
阵奥雅=Trận áo nhã
王奥雅=Vương áo nhã
江牧之=Giang Mục Chi
周小楼=Chu Tiểu Lâu
李伏威=Lý Phục Uy
黑先生=Hắc tiên sinh
赵牙子=Triệu Nha Tử
海子富=Hải Tử Phú
刘一峰=Lưu Nhất Phong
吕小布=Lã Tiểu Bố
杨兮兮=Dương Hề Hề
黎本清=Lê Bản Thanh
龙警长=Long cảnh trưởng
王向导=Vương dẫn đường
王伙计=Vương người làm thuê
金刚爪=Kim Cương Trảo
焦英云=Tiêu Anh Vân
钱掌柜=chưởng quỹ Tiền
布武使=Bố Võ Sứ
原雪涧=Nguyên Tuyết Giản
墨菲托斯=Mephisto
史莱德=Slade
阎王怕=Diêm Vương Phạ
三家港=Tam Gia cảng
程家央=Trình gia ương
黄教官=sĩ quan huấn luyện Hoàng
钟队长=Chung đội trưởng
马德拉斯=Madras
向闻西=Hướng Văn Tây
墨卡托=Mercator
李教官=sĩ quan huấn luyện Lý
余寒武=Dư Hàn Vũ
赵教头=giáo đầu Triệu
高时明=Cao Thời Minh
高太监=thái giám Cao
杨天梁=Dương Thiên Lương
菩道仙=Bồ Đạo Tiên
天线宝宝=Thiên Tuyến Bảo Bảo
柳芙微=Liễu Phù Vi
熊一郎=Kumaichirō
前海警=Tiền Hải Cảnh
王赐信=Vương Tứ Tín
林鸿铭=Lâm Hồng Minh
梨惠子=Rieko
恩佐斯=N'Zoth
亚煞极=Y'Shaarj
上谷凉香=Kamiya Ryohka
千机戒=thiên cơ giới
迦罗娜=Garona
林铁柱=Lâm Thiết Trụ
林英俊=Lâm Anh Tuấn
林漂亮=Lâm Phiêu Lượng
陈子义=Trần Tử Nghĩa
维尔顿=Weldon
阿莱克斯=Alexis
詹尼斯=Jannice
唐天云=Đường Thiên Vân
威格玛=Wigma
暗炉城=Shadowforge
吕三胜=Lã Tam Thắng
陈志禹=Trần Chí Vũ
李秀秀=Lý Tú Tú
洛兵锋=Lạc Binh Phong
艾森娜=Aessina
美智子=Michiko
贾富贵=Giả Phú Quý
杜雯女士=quý cô Đỗ Văn
海达希亚=Hydraxian
瑟拉塞恩=Therazane
耐普图隆=Neptulon
奥拉基尔=Al'Akir
萧老爷=Tiêu lão gia
高山波=Cao Sơn Ba
刘祥林=Lưu Tường Lâm
梁之志=Lương Chi Chí
唐世生=Đường Thế Sinh
武山明=Võ Sơn Minh
朝先阳=Triều Tiên Dương
百炼胜=Bách Luyện Thắng
段武明=Đoạn Võ Minh
赫连城=Hách Liên Thành
张汉民=Trương Hán Dân
严先生=Nghiêm tiên sinh
严石斌=Nghiêm Thạch Bân
墨姐姐=Mặc tỷ tỷ
李成严=Lý Thành Nghiêm
陆寿永=Lục Thọ Vĩnh
陆有天=Lục Hữu Thiên
林光定=Lâm Quang Định
功劳叔=Công Lao thúc
郑秀妍=Jung Soo-yeon
权宁一=Kwon Nyeong Il
林显明=Lâm Hiển Minh
吴夏荣=Oh Ha-young
董时叶=Đổng Thời Diệp
李嫂子=chị dâu Lý
李大姐=chị Lý
方定武=Phương Định Võ
法石碌=Pháp Thạch Lục
弗利沙=Frieza
特兰克斯=Trunks
特兰克=Trunk
孙悟天=Son Goten
黄爪子=Hoàng Trảo Tử
白国士=Bạch Quốc Sĩ
马督公=Mã đốc công
田九九=Điền cửu cửu
周师傅=Chu sư phó
斯蒂芬森=Stephanson
黄中山=Hoàng Trung Sơn
玻璃匠=thợ thủy tinh
元喜龙=Won Hee-ryong
李承灿=Lee Seung-chan
朴正男=Park Jung-nam
李志国=Lee Ji-guk
严茗持=Nghiêm Mính Trì
林衙内=nha nội Lâm
方敬涵=Phương Kính Hàm
苟成新=Cẩu Thành Tân
张大户=Trương đại hộ
天药老人=Thiên Dược lão nhân
石林虎=Thạch Lâm Hổ
司徒心=Tư Đồ Tâm
王柠书=Vương Nịnh Thư
莫显铭=Mạc Hiển Minh
曹真霜=Tào Chân Sương
万花花=Vạn Hoa Hoa
周平平=Chu Bình Bình
徐正君=Từ Chính Quân
鲁头陀=Lỗ Đầu Đà
徐之文=Từ Chi Văn
石云峰=Thạch Vân Phong
徐之志=Từ Chi Chí
马兄弟=Mã huynh đệ
林全福=Lâm Toàn Phúc
林老板=ông chủ Lâm
独孤所长=Cô Độc sở trưởng
符有三=Phù Hữu Tam
朱九黎=Chu Cửu Lê
吴广胜=Ngô Quảng Thắng
周堂生=Chu Đường Sinh
克瑞丝塔=Krista
章福元=Chương Phúc Nguyên
胡杜山=Hồ Đỗ Sơn
时大哥=Thời đại ca
井院长=Tỉnh viện trưởng
贾代全=Giả Thay Toàn
冯渔庭=Phùng Ngư Đình
李道端=Lý Đạo Đoan
赵笑恺=Triệu Tiếu Khải
郑贤超=Trịnh Hiền Siêu
赵学恺=Triệu Học Khải
林二狗=Lâm Nhị Cẩu
吴中天=Ngô Trung Thiên
王宝峰=Vương Bảo Phong
谢托利斯=Setolis
皇北樱=Hoàng Bắc Anh
文会长=Văn hội trưởng
达尔达尼亚=Dardania
安娜斯塔西亚=Anastasia
弗里德里希=Friedrich
波德莱尔=Baudelaire
王老爷=Vương lão gia
阎管事=quản sự Diêm
金钟国=Kim Jong-kook
李昌运=Lý Xương Vận
常威勇=Thường Uy Dũng
万三夫=Vạn Tam Phu
马老六=Mã lão lục
郑三刀=Trịnh Tam Đao
赵明仁=Jo Myung-jin
金哲修=Kim Chul-soo
李政宰=Lee Jung-jae
李在镕=Lee Jae-yong
苟布理=Cẩu Bố Lý
胡烂眼=Hồ Lạn Nhãn
诸大当家=đại đương gia Chư
马师爷=Mã sư gia
阿弗纳斯=Avernas
拉兹特=Razt
涅诺斯=Nenos
阿格拉隆=Aglarond
莫拉罕=Morahan
纳托利斯=Natolis
王弘诲=Vương Hoằng Hối
gogo=Gogo
威廉姆=William
昂布莱尔=Umbrell
方济各=Francis
杰兰扎尼=Geranzani
德川幕府=Tokugawa Mạc Phủ
佩索阿=Pessoa
大三吧=thánh Paul
白多碌=Bạch Đa Lục
张东家=ông chủ Trương
裴莉秀=Bùi Lỵ Tú
严东家=ông chủ Nghiêm
梁仁埔=Lương Nhân Bộ
秋月种=Akizuki Shintetsu
朴圭翰=Park Kyu-han
郭掌柜=Quách chưởng quỹ
秋月大人=Akizuki đại nhân
文掌柜=Văn chưởng quỹ
立花家=nhà Tachibana
沈老掌柜=Thẩm lão chưởng quỹ
千叶寻=Thiên Diệp Tầm
文主席=chủ tịch Văn
刘宝瑞=Lưu Bảo Thuỵ
林萍萍=Lâm Bình Bình
麦克斯=Max
立花鉴速=Tachibana Kansu
立花鉴=Tachibana
王洛滨=Vương Lạc Tân
唐春晓=Đường Xuân Hiểu
里维斯=Reeves
西门催=Tây Môn Thôi
弗格森=Ferguson
席组长=tổ trưởng Tịch
柳入世=Liễu Vào Đời
阿兹利尔=Azril
乔镇兴=Kiều Trấn Hưng
乔为民=Kiều Vi Dân
裳禔亚=Shangya
格乌什=Gruumsh
春六娘=Xuân Lục Nương
李和蕴=Lý Hoà Uẩn
奎尔多雷=Quel'dorei
恩瑞希尔=Enrique Hill
张地主=Trương địa chủ
刘瘸子=Lưu người què
阿兹利尔斯=Azlils
唐铭尘=Đường Minh Trần
克伦多=Karenda
陈浩天=Trần Hạo Thiên
汪师爷=Uông gia sư
符柏文=Phù Bách Văn
奎尔克扎德=Quelkzad
考维特=Corvette
巴拿巴=Barnabas
查韦斯=Chávez
韩一平=Hàn Nhất Bình
门多萨=Mendoza
诸老大=Chư lão đại
迪亚娜=Diana
诺登飞=Norden Fly
萨迪沃=Sardior
法拉祖尔=Falazure
阿克苏耶=Aksuye
艾尼寇恩=Enicohen
莫辛－纳干=Mosin-Nagant
岗萨雷斯=Gonzales
戚大少爷=Thích đại thiếu gia
刘帮主=Lưu bang chủ
郑一官=Trịnh Nhất Quan
罗尘空=La Trần Không
剑无一=Kiếm Vô Nhất
刘首领=Lưu thủ lĩnh
西多尼亚=Sidonia
林大少=Lâm đại thiếu
刘船长=Lưu thuyền trưởng
阿拉贡内斯=Aragones
斯卡伯罗=Scaborough
小树子=tiểu Thụ tử
刘千户=Lưu thiên hộ
百晓通=Bách Hiểu Thông
陈盛宇=Trần Thịnh Vũ
周三诸夥=Chu Tam Chư Khoả
张机器=Trương Cơ Khí
周老猫=Chu mèo già
王三狗=Vương Tam Cẩu
林功劳=Lâm Công Lao
张船匠=Trương thợ thuyền
马嘎尔尼=Marganey
熊占卜=Hùng Chiêm Bốc
阿澜驰=Alanchi
陈指挥=Trần chỉ huy
lee=Lee
唐国强=Đường Quốc Cường
名深河=tên Thâm Hà
林允儿=Im Yoona
菲妮克丝=Phoenix
金武星=Kim Moo-sung
郑舜臣=Chung Sun-sin
白昌洙=Baek Chang-ju
海洛伊丝=Heloise
朴槿惠=Park Geun-hye
程蝶衣=Trình Điệp Y
吴倩莲=Ngô Thiến Liên
意味着=ý nghĩa là
腐狼群=đàn sói
麦比乌斯=Moebius
沐希郡=Mộc Hi Quận
刁定国=Điêu Định Quốc
毕方达=Tất Phương Đạt
张亚东=Trương Á Đông
李心洁=Lý Tâm Khiết
郑晓龙=Trịnh Hiểu Long
毕督领=Hết đốc lĩnh
杨晓培=Dương Hiểu Bồi
宁正生=Ninh Chính Sinh
戈黛特=Godet
马迪娜=Madina
洛克维尔=Rockville
克鲁尼=Clooney
萨姆洛克·维尔=Sam Rockville
德尼罗=De Niro
帕西诺=Pacino
宋金明=Tống Kim Minh
考斯里克=Koslick
科斯里克=Koslick
德哈德=Dehard
莫里茨=Moritz
张伟平=Trương Vĩ Bình
李大户=Lý đại hộ
李十三=Lý Thập Tam
席营长=Tịch doanh trưởng
马首长=Mã thủ trưởng
苟老爷=Cẩu lão gia
得过去=qua được
李允琳=Lee Yoon-im
崔镇浩=Choi Jin-ho
洪胜成=Hong Seung-sung
朴振英=Park Jin-young
李康焕=Lee Kang-hwan
刘正福=Yoo Jeong-bok
李浩彦=Lee Ho-yeon
金英敏=Kim Young-min
李秀满=Lee Soo-man
黄老爷=Hoàng lão gia
阮小五=Nguyễn Tiểu Ngũ
阮小二=Nguyễn Tiểu Nhị
阮小七=Nguyễn Tiểu Thất
朴孝敏=Park Hyomin
金光洙=Kim Kwang-soo
宋智孝=Song Ji-hyo
李玉和=Lý Ngọc Hoà
刘花英=Ryu Hwa-young
李在贤=Lee Jae-hyun
洪佳慧=Hong Ga-hye
张举人=Trương cử nhân
玉泽生=Ok Taek-sang
李恩硕=Lee Eun-suk
金泰村=Kim Tae-chon
清凉里=Cheongnyangni
徐珠贤=Seo Ju-hyun
李章宇=Lee Jang-woo
鲍振江=Bào Chấn Giang
胡晓叶=Hồ Hiểu Diệp
刘永宏=Lưu Vĩnh Hoằng
阿Sa=A Sa
林志颖=Lâm Chí Dĩnh
黄Sir=Hoàng Sir
小马哥=Mark 'Gor' Lee
巴拉贝鲁姆=Parabellum
王重阳=Vương Trùng Dương
陈文媛=Trần Văn Viện
林迪安=Lâm Địch An
fbi=FBI
黄圣依=Hoàng Thánh Y
何建军=Hà Kiến Quân
冯小宁=Phùng Tiểu Ninh
张雅璇=Trương Nhã Toàn
成青松=Thành Thanh Tùng
林建岳=Lâm Kiến Nhạc
五六半=súng bán tự động T56
麦兆辉=Mạch Triệu Huy
时大夫=bác sĩ Thì
李润福=Lý Nhuận Phúc
黄又南=Hoàng Hựu Nam
李力持=Lý Lực Trì
林丽珍=Lâm Lệ Trân
李添胜=Lý Thiêm Thắng
李修贤=Lý Tu Hiền
刘嘉豪=lưu Gia Hào
梁咏琪=Lương Vịnh Kỳ
杨丽萍=Dương Lệ Bình
吴思远=ngô tư viễn
蔡卓妍=Thái Trác Nghiên
黄一飞=Hoàng Nhất Phi
郑秀文=Trịnh Tú Văn
班克罗夫特=Bancroft
叶锦鸿=Diệp Cẩm Hồng
任达华=Nhậm Đạt Hoa
刘德凯=Lưu Đức Khải
大玉儿=Đại Ngọc Nhi
赖水清=Lại Thuỷ Thanh
马景涛=Mã Cảnh Đào
苏茉儿=Tô Mạt Nhi
杨亚洲=Dương Á Châu
朱媛媛=Chu Viện Viện
尤小刚=Vưu Tiểu Cương
深田小姐=Fukada tiểu thư
佩德罗=Pedro
深田恭子=Fukada Kyouko
铃木保奈美=Suzuki Honami
何韵诗=Hà Vận Thi
许志安=Hứa Chí An
陈明英=Trần Minh Anh
虞戡平=Ngu Kham Bình
魏绍恩=Nguỵ Thiệu Ân
陆奕静=Lục Dịch Tĩnh
庄文强=Trang Văn Cường
谭耀文=Đàm Diệu Văn
高怡平=Cao Di Bình
周瑛琦=Chu Anh Kỳ
大岛渚=Oshima Nagisa
北野武=Kitano Takeshi
菲烈特=Fellite
张洪量=Trương Hồng Lượng
黄春明=Hoàng Xuân Minh
邱坤良=Khâu Khôn Lương
归亚蕾=Quy Á Lôi
陈坤厚=Trần Khôn Hậu
廖庆松=Liệu Khánh Tùng
王晓祥=Vương Hiểu Tường
啤啤熊=Ti Ti Hùng
得得意=Đắc Đắc Ý
费迪南德=Ferdinand
莫倩茹=Mạc Thiến Như
梁荣忠=Lương Vinh Trung
越王勾践=Việt Vương Câu Tiễn
赵维威=Triệu Duy Uy
海因里希=Heinrich
甄咏蓓=Chân Vịnh Bội
郑中基=Trịnh Trung Cơ
肥仔聪=Phì Tử Thông
冯天运=Phùng Thiên Vận
我们俩=Hai Chúng Ta
市川尚三=Ichikawa Shangzo
麦绍堂=Mạch Thiệu Đường
余文乐=Dư Văn Nhạc
乔恩亚瑟=Jon Arthur
亚曼尔提=Yamanti
科霍尔=Kohall
沙弥尔=Shamir
万弘杰=Vạn Hoằng Kiệt
刘青云=Lưu Thanh Vân
玛古希尔=Magushir
张坚庭=Trương Kiên Đình
刘镇伟=Lưu Trấn Vĩ
吴光正=Ngô Quang Chính
戈达尔=Godard
詹Sir=Chiêm Sir
霍部长=Hoắc bộ trưởng
孟子良=Mạnh Tử Lương
任同延=Nhận Đồng Diên
黄子华=Hoàng Tử Hoa
陈惠敏=Trần Huệ Mẫn
陈百祥=Trần Bách Tường
许冠文=Hứa Quan Văn
邹凯光=Trâu Khải Quang
谷德昭=Cốc Đức Chiêu
张达明=Trương Đạt Minh
樋口明日嘉=Higuchi Asuka
葛民辉=Cát Dân Huy
靓仔青=Tịnh Tử Thanh
杜汶泽=Đỗ Vấn Trạch
韦家辉=Vi Gia Huy
黄小蕾=Hoàng Tiểu Lôi
任媛媛=Nhậm Viện Viện
罗永昌=La Vĩnh Xương
徐锦江=Từ Cẩm Giang
叶子媚=Diệp Tử Mi
林熙蕾=Lâm Hy Lôi
蔡明亮=Thái Minh Lượng
马永贞=Mã Vĩnh Trinh
来一根吗=lấy một điếu
朴正炫=Park Jung-hyun,
崔雪莉=Choi Sulli
李敏镐=Lee Min-ho
俞承豪=Yoo Seung-ho
裴勇俊=Bae Yong-joon
裴斗娜=Bae Doona
赵春林=Triệu Xuân Lâm
具荷拉=Goo Hara
金灿美=Kim Chan-mi,
彭延辉=Bành Diên Huy
朴初雅=Park Cho-a
金浩尚=Kim Ho-sang
韩善花=Han Sun-hwa
朴海善=Park Hae-sun
金泰宇=Kim Tae-woo
朴孝信=Park Hyo-shin
李善姬=Lee Sun-hee
申东烨=Shin Dong-yup
蒂亚罗佩=Tialope
安格拉莫=Angelamo
田大妈=dì Điền
陈捍东=Trần Hãn Đông
耐亘德罗=Negendro
林静平=Lâm Tĩnh Bình
张叔平=Trương Thúc Bình
秦大柱=Tần Đại Trụ
张永宁=Trương Vĩnh Ninh
耐萨托莉雅=Nesatolia
卡图斯=Catus
祝雨辛=Chúc Vũ Tân
还是一样=thì vẫn thế
梁兴栋=Lương Hưng Đống
武方候=Võ Phương Hậu
霍署长=Hoắc sở trưởng
莫轻舞=Mạc Khinh Vũ
大玄师=Đại Huyền Sư
“琴”=“Cầm”
焦雄屏=Tiêu Hùng Bình
毓越老师=Dục Việt lão sư
霍伯伯=Hoắc bá bá
蒋雪柔=Tưởng Tuyết Nhu
林俊杰=Lâm Tuấn Kiệt
铁心兰=Thiết Tâm Lan
楚湘湘=Sở Tương Tương
扁素问=Biển Tố Vấn
京花姐=Kinh Hoa tỷ
李成儒=Lý Thành Nho
韩三平=Hàn Tam Bình
桑德琳=Sandrine
杨德昌=Dương Đức Xương
古加尔=Guldan
山姆士=Samson
小勺子=Muỗng Nhỏ
卞智洪=Biện Trí Hồng
张哲修=Trương Triết Tu
白蔓妮=Bạch Mạn Ni
斯达特男爵=Stark nam tước
史莱特=Slater
李小婉=Lý Tiểu Uyển
黄健中=Hoàng Kiện Trung
伯特因=Hubert
安瑞恩=AnRyan
凯文因缺思厅=Kevin Interesting
奥尔喀什=Orkash
艾拉迪亚=Aladia
坦格里安=Targaryen
泰达米尔=Tryndamere
布莱克希娅=Blakia
奥尔托伦索=Altolenzo
李大发=Lý Đại Phát
李鸿基=Lý Hồng Cơ
奥黛塔=Odetta
科尔斯顿=Colston
鲍威尔=Powell
董晟睿=Đổng Thạnh Duệ
陆尓豪=Lục Nhĩ Hào
梁景东=Lương Cảnh Đông
杨荔娜=Dương Lệ Na
马党卫=Mã đảng vệ
马总参谋长=Mã tổng tham mưu trưởng
萧青山=Tiêu Thanh Sơn
绍央兄=Thiệu Ương huynh
怀玉兄=Hoài Ngọc huynh
子鱼兄=Tử Ngư huynh
李言中=Lý Ngôn Trung
孙站长=Tôn trạm trưởng
娜塔莎=Natasha
两味爷=lưỡng vị gia
王志文=Vương Chí Văn
刘佩琦=Lưu Bội Kỳ
潘粤明=Phan Việt Minh
刘家成=Lưu Gia Thành
波茨坦=Potsdam
阿尔冯斯=Alphonse
杜小月=Đỗ Tiểu Nguyệt
祝君豪=Chúc Quân Hào
丰绅殷德=Phong Thân Ân Đức
邹静之=Trâu Tĩnh Chi
邓建国=Đặng Kiến Quốc
桂纶镁=Quế Luân Mỹ
陈柏霖=Trần Bách Lâm
王宝钏=Vương Bảo Xuyến
过去玩=qua chơi
鲁晓威=Lỗ Hiểu Uy
天猫霸气=Thiên Miêu bá khí
刘小锋=Lưu Tiểu Phong
李立群=Lý Lập Quần
焦恩俊=Tiêu Ân Tuấn
范小天=Phạm Tiểu Thiên
马德华=Mã Đức Hoa
寇占文=Khấu Chiêm Văn
顾惜朝=Cố Tích Triều
贾静雯=Giả Tịnh Văn
尹晓音=Doãn Hiểu Âm
宁大官人=Ninh đại quan nhân
张文顺=Trương Văn Thuận
吕丽萍=Lã Lệ Bình
赵一军=Triệu Nhất Quân
丛志军=Tùng Chí Quân
姜鸿波=Khương Hồng Ba
董汉臣=Đổng Hán Thần
秦海璐=Tần Hải Lộ
伯格曼=Bergman
蔡卫东=Thái Vệ Đông
李丛喜=Lý Tùng Hỉ
徐营捷=Từ Doanh Tiệp
凡尔纳=Verne
黑面蛟=Hắc Diện Giao
马委员=Mã uỷ viên
滕文骥=Đằng Văn Ký
杨少鹏=Dương Thiếu Bằng
向日龙=Hướng Nhật Long
素凝真=Tố Ngưng Chân
洪一公=Hồng Nhất Công
牛青峰=Ngưu Thanh Phong
诸綵老=Chư Thải lão
孙红雷=Tôn Hồng Lôi
柳悄悄=Liễu Tiễu Tiễu
林奇衣=Lâm Kỳ Y
林夕雨=Lâm Tịch Vũ
张大富=Trương Đại Phú
李梦瑶=Lý Mộng Dao
唐马儒=Đường Mã Nho
赵敏芬=Triệu Mẫn Phân
宁哥哥=Ninh ca ca
拱卫司=Củng Vệ ty
朱宏嘉=Chu Hoành Gia
白木崖=Bạch Mộc Nhai
白飞飞=Bạch Phi Phi
安德瑞=Andheri
先生女士=quý ông quý bà
平鑫涛=Bình Hâm Đào
瘟疫医生=plague doctor
林飞冲=Lâm Phi Xung
任你们=Nhiệm Nhĩ Môn
眉千笑=Mi Thiên Tiếu
眉光明=Mi Quang Minh
秋景沅=Thu Cảnh Nguyên
楚司南=Sở Ty Nam
李翊君=Lý Dực Quân
陈中维=Trần Trung Duy
蒋勤勤=Tương Cần Cần
李小冉=Lý Tiểu Nhiễm
吕良伟=Lã Lương Vĩ
李少红=Lý Thiếu Hồng
越青依=Việt Thanh Y
越文谦=Việt Văn Khiêm
毛小睿=Mao Tiểu Duệ
盖尔·加朵=Gal Gadot
赵圆圆=Triệu Viên Viên
田晓鹏=Điền Hiểu Bằng
贾宏声=Giả Hoằng Thanh
方白羽=Phương Bạch Vũ
卡洛琳=Caroline
丽安娜=Lianna
葛优凭=Cát Ưu Bằng
邱淑贞=Khưu Thục Trinh
李小璐=Lý Tiểu Lộ
布里吉斯=Bridges
里吉斯=Regis
谢里丹=Sheridan
黄蜀芹=Hoàng Thục Cần
田壮壮=Điền Tráng Tráng
许崇山=Hứa Sùng Sơn
移星剑派=Dời Sao Kiếm Phái
聂丫头=Nhiếp nha đầu
倪远山=Nghê Viễn Sơn
聂双双=Nhiếp Song Song
李潇侣=Lý Tiêu Lữ
高曙光=Cao Thự Quang
黄海冰=Hoàng Hải Băng
奥古斯特=August
小心心=tiểu Tâm Tâm
欧阳常林=Âu Dương Thường Lâm
萧组长=tổ trưởng Tiêu
田志斌=Điền Chí Bân
释小龙=Thích Tiểu Long
张凯丽=Trương Khải Lệ
孙树培=Tôn Thụ Bồi
戴春荣=Đái Xuân Vinh
福尔泰=phúc Nhĩ Thái
福尔康=phúc Nhĩ Khang
孟小冬=Mạnh Tiểu Đông
墨水心=Mặc Thuỷ Tâm
林瑞阳=Lâm Thuỵ Dương
陈志朋=Trần Chí Bằng
奥利弗=Oliver
何琇琼=Hà Tú Quỳnh
墨玉合=Mặc Ngọc Hợp
小青子=tiểu Thanh tử
王靖雯=Vương Tĩnh Văn
宁知非=Ninh Tri Phi
左小姐=Tả tiểu thư
贾章柯=Giả Chương Kha
苗翠花=Miêu Thuý Hoa
姜娉婷=Khương Sính Đình
英格林=Inglein
特尤德蒙德=Teyodmund
格阿蒂斯=Gratis
斯温先生=Swen tiên sinh
曹大妈=bác gái Tào
邓恩多夫=Dunndorf
卡萝尔=Carol
克莱门斯=Clemens
格拉蒂斯=Gratis
杰里柯=Jericho
赫卡特伯爵=Hecate bá tước
吴运铎=Ngô Vận Đạc
armstrong=Armstrong
威灵顿=Wellington
海伦娜=Helena
龚振麟=Cung Chấn Lân
萨默尔=Sammer
白可卿=Bạch Khả Khanh
顾秋情=Cố Thu Tình
安知鱼=An Tri Ngư
贝纳多特=Bernadotte
塔列朗=Talleyrand
马老师=Mã lão sư
童，林=Đồng, Rừng
林，童=Lâm, Đồng
唐妹妹=Đường muội muội
伍叔叔=Ngũ thúc thúc
唐迎秋=Đường Nghênh Thu
陈师中=Trần Sư Trung
孙一峰=Tôn Nhất Phong
伍晨曦=Ngũ Thần Hi
沈启南=Thẩm Khải Nam
魏璎珞=Nguỵ Anh Lạc
阿花哥=A Hoa Ca
电音如来=Điện Âm Như Lai
李海洋=Lý Hải Dương
钟伯通=Chung Bá Thông
星河剑圣=Ngân Hà Kiếm Thánh
逍遥乘风诀=Tiêu Dao Thuận Gió Quyết
大天河真气=Đại Thiên Hà Chân Khí
铁空山=Thiết Không Sơn
化铁手=Hoá Thiết Thủ
铁灵儿=Thiết Linh Nhi
秦逍遥=Tần Tiêu Dao
田顺花=Điền Thuận Hoa
巴雅尔=Bayaer
曹大姐=chị Tào
晓芹姐=chị Hiểu Cần
赵晓芹=Triệu Hiểu Cần
陈木生=Trần Mộc Sinh
大跃进的=Đại Nhảy Vọt
反应釜=nồi phản ứng
幻空网=Huyễn Không võng
凤予飞=Phượng Dư Bay
顾冬藏=Cố Đông Tàng
楚天行=Sở Thiên Hành
利马窦=Matteo Ricci
徐光启=Từ Quang Khải
梅特涅=Metternich
弗朗茨·约瑟夫=Franz Joseph
法老王=Pháp Lão Vương
元校尉=Nguyên hiệu úy
玛丽安娜=Marianne
威尔特=Wilt
12天=12 ngày
阿列克斯=Alex
艾格尼丝=Agnes
卡迪央=Cadignan
忒休斯=Theseus
阿历克斯=Alex
康斯坦丁=Constantine
塞西莉亚=Cecilia
弗洛里昂=Florian
罗特列克=Lautrec
克尔松=Kelson
勒鲁什=Lelouch
克洛维斯=Clovis
季无声=Quý Vô Thanh
艾菲尔=Eiffel
菲勒教授=giáo sư Feller
林传清=Lâm Truyền Thanh
吴旷明=Ngô Khoáng Minh
克莱曼=Kleinman
卓馆长=Trác quán trưởng
卓叔叔=Trác thúc thúc
名字很长机关=cơ quan Tên Siêu Dài
沙摩浑=Sa Ma Hồn
周是翟=Chu Thị Địch
方忆静=Phương Ức Tĩnh
邬首长=Ô thủ trưởng
郭津津=Quách Tân Tân
刘三八=Lưu Tam Bát
田三五=Điền Tam Ngũ
郭三娘=Quách Tam Nương
马老爹=Mã lão tía
马叔叔=Mã thúc thúc
阿娜颜=Anayan
登瀛洲号=Tiến Về Doanh Châu Tàu
李赤骑=Lý Xích Kỵ
张宇辰=Trương Vũ Thần
pepi=Pepi
孙可成=Tôn Khả Thành
司南城=Ty Nam thành
梁存厚=Lương Tồn Hậu
孙掌柜=Tôn chưởng quỹ
p小姐=P tiểu thư
pepei=Pepei
拉格什=Lagash
别祖霍夫=Bezoukhov
梅丽莎=Melissa
伊泽瑞尔=Ezreal
瓦尔特=Walter
欧仁妮=Eugénie
霍亨索伦=Hohenzollern
司马广=Tư Mã Quảng
刘昌清=Lưu Hưng Thanh
阿什坎迪=Ashkandi
海达希尔=Hydraxian
达尔豪斯=Dalhousie
猴王大人=hầu vương đại nhân
青翼都=Thanh dực đô
脱离我们=rời khỏi chúng ta
萧委员=Tiêu uỷ viên
以死气=lấy cái tử khí
烟锁池塘柳=yên toả trì đường liễu
指玄丹=Chỉ Huyền đan
大般涅盘经=đại bàn niết bàn kinh
大般泥洹经=đại bàn nê hoàn kinh
长阿含经=trường a hàm kinh
牵丝戏=Khiên Ti Kịch
眼中人是面前人=nhãn trung nhân thị diện tiền nhân
黄龙士=Hoàng Long Sĩ
范西屏=Phạm Tây Bình
碧血丹青=Bích Huyết Đan Thanh
乐夫人=Nhạc phu nhân
将此人=đem người này
小棋宗=tiểu kỳ tông
晋太宗=Tấn Thái Tông
赵晓东=Triệu Hiểu Đông
程小东=Trình Tiểu Đông
黄树文=Hoàng Thụ Văn
董建飞=Đổng Kiến Phi
马向山=Mã Hướng Sơn
苏慕珊=Tô Mộ San
洛克莫丹=Loch Modan
雷德.黑手=Rend Blackhand
麦姆.黑手=Maim Blackhand
王少安=Vương Thiếu An
奥克兰克=Alterac
千愿树=thiên nguyện thụ
李光和=Lý Quang Hoà
嘉丽雅=Calia
嘉丽雅.米奈希尔=Calia  Menethil
奥里登=Aliden
奥里登.匹瑞诺德，=Aliden . Perenolde,
奥里登.匹瑞诺德=Aliden . Perenolde
九悔仙=cửu hối tiên
格里安.斯托曼=Gryan Stoutmantle
欧也尼.葛朗台。=Eugénie Grandet
特雷姆斯=Teremus
布鲁塔卢斯=Brutallus
伊兰尼库斯=Eranikus
加尔鲁什=Garrosh
加尔鲁什.地狱咆哮=Garrosh Hellscream
希利苏斯=Sililhus
布瑞尔=Brill
玛诺洛斯=Mannoroth
托尔巴拉德=Tol Barad
比格拉斯=Tigolas
艾尔文=Elwynn
贝尔托恩=Trollbane
卡扎克=Kazzak
托尔贝恩=Trollbane
索拉斯,贝尔托恩=Galen Trollbane
索拉斯=Thoras
梅里. 冬风=Meryl Winterstorm
林小哥=Lâm tiểu ca
瓦特.泽.法克=What The Fuck
索拉.碎星者=Sora Starshatter
梅里.冬风=Meryl Winterstorm
赞达拉=Zandalar
阿斯塔洛=Astalor
裴小林=Bùi Tiểu Lâm
拉格纳罗斯=Ragnaros
裴长老=Bùi Trưởng Lão
戚悉前辈=Thích Tất tiền bối
暗影猎手=Shadow Hunter
后勤君=hậu cần-kun
格罗姆什.地狱咆哮=Grommash Hellscream
孙俪姣=Tôn Lệ Giảo
阿纳斯塔纳安=Anasterian
众蚁噬象=bầy kiến ăn voi
这些人=những người này
慈悲心肠=lòng dạ từ bi
萧问道=Tiêu Vấn Đạo
王多多=Vương Đa Đa
孙彦青=Tôn Ngạn Thanh
弓月英=Cung Nguyệt Anh
王晋海=Vương Tấn Hải
蓝星联盟=Lam Tinh liên minh
李道忠=Lý Đạo Trung
齐弟弟=Tề đệ đệ
李友庭=Lý Hữu Đình
赵芳华=Triệu Phương Hoa
刘宏远=Lưu Hồng Viễn
青山银次=Aoyama Ginji
阿莱克丝塔萨=Alexstrasza
森田美树=Morita Miki
森田茂男=Morita Shigeo
小田一郎=Oda Ichiro
张新宇=Trương Tân Vũ
璋慕莨=Chương Mộ Lang
马世龙=Mã Thế Long
秦牧南=Tần Mục Nam
严平西=Nghiêm Bình Tây
赵康劭=Triệu Khang Thiệu
工藤新一=Kudo Shinichi
阿斯兰.祈安=Athrun Zala
马奇诺=Maginot
亚马托=Yamato
罗志同=La Chí Đồng
李彬超=Lý Bân Siêu
邓文迪=Đặng Văn Địch
奥格瑞姆?毁灭之锤=Orgrim Doomhammer
斯特劳斯=Strauss
真水诀=Chân Thuỷ Quyết
澹台静=Đạm Đài Tĩnh
冯德洛尔=Vandellor
莉亚德琳=Liadrin
洛瑟玛=Lor'themar
哈杜伦=Halduron
陈青羽=Trần Thanh Vũ
苏姗紫=Tô San Tử
达尔坎=Dar'Khan
莎安娜=Shaanna
纳罗拉克=Nalorakk
秦征仪=Tần Chinh Nghi
华筝伊=Hoa Tranh Y
李云迪=Lý Vân Địch
严雨闲=Nghiêm Vũ Nhàn
雷秀芬=Lôi Tú Phân
陈志新=Trần Chí Tân
周不凡=Chu Bất Phàm
星辰九转=Tinh Thần Cửu Chuyển
冰卧雪=Băng Ngoạ Tuyết
齐麟志=Tề Lân Chí
云归山=Vân Quy Sơn
云归海=Vân Quy Hải
狼群游=lang quần du
阿苏斯=Asus
尹依依=Doãn Y Y
麦格娜=Magna
蒋冻大=Tưởng Đống Đại
蒋冻听=Tưởng Đống Thính
青山君=Aoyama-kun
赵晓彤=Triệu Hiểu Đồng
赵大同=Triệu Đại Đồng
严姑娘=Nghiêm cô nương
陈怡琳=Trần Di Lâm
陈唯琴=Trần Duy Đàn
周建功=Chu Kiến Công
陈淑仪=Trần Thục Nghi
姜淑仪=Khương Thục Nghi
姜淑怡=Khương Thục Di
张慧琳=Trương Tuệ Lâm
龙青云=Long Thanh Vân
周馆主=Chu quán chủ
泰伦.血魔=Teron Gorefiend
泰隆血魔=Teron Gorefiend
壁炉谷=Hearthglen
姬先生=Cơ tiên sinh
东城树=Đông Thành Thụ
王启年=Vương Khải Niên
血魔子=Huyết Ma Tử
姬教习=Cơ giáo tập
周先生=Chu tiên sinh
姬无垢=Cơ Vô Cấu
拓跋无心=Thác Bạt Vô Tâm
周小萌=Chu Tiểu Manh
基因武学=võ học gien
林初雪=Lâm Sơ Tuyết
雨雁雪=Vũ Nhạn Tuyết
伦次德=Alenquer
月神黛安娜=thần mặt trăng Diana
的大文豪奥斯瓦尔多=đại văn hào Osvaldo
埃博拉人=người Ebola
弗兰克议员=nghị viên Frank
马拉卡尼少爷=thiếu gia Maracani
西沃斯少爷=thiếu gia Sibos
阿努比斯=Anubis
落李小姐=tiểu thư Roli
芬格尔斯小姐=tiểu thư Fengelth
格利沙尔塔小姐=tiểu thư Glisarta
欧几里德=Euclid
加布里尔三世陛下=Gabriel đệ tam bệ hạ
斯罗兰小子=nhóc con Seland
伯德纹=Baldwin
水凌波=Thuỷ Lăng Ba
的斯罗兰小子=nhóc con Seland
安德烈上将=đô đốc Andre
雅兰斯女士=quý cô Yallands
斯兰罗小子=nhóc con Seland
谢小兼=Tạ Tiểu Kiêm
海盗梦想=cướp biển giấc mơ
林之言=Lâm Chi Ngôn
安德烈公爵=công tước Andre
达斯雷玛=Dath'Remar
血骑士=Blood Knight
艾格博特先生=tiên sinh Eggburt
海曼·马克西姆先生=tiên sinh Herman · Maxime
崔斯特.杜登=Drizzt Durden
里拉斯=Lirath
埃博拉商人=thương nhân Ebola
埃博拉=Ebola
温蕾萨=Vereesa
常极右=Thường Cực Hữu
阿纳斯塔里安=Anasterian
克伦威尔?加里瑟斯=Cromwell  Garithos
奥斯玛尔=Othmar
瓦里玛萨斯=Varimathras
奥斯玛尔?加里瑟斯=Othmar Garithos
茉德拉=Modera
克拉苏斯=Krasus
德兰登=Delanden
哈杜伦.明翼=Halduron Brightwing
约翰.斯温=John Sven
雅兰斯夫人=phu nhân Yallands
泰隆.血魔=Teron Gorefiend
洛卡玛.利齿=Rakmar Sharpfang
吉恩.格雷迈恩=Genn Greymane
奥格瑞姆.毁灭之锤=Orgrim Doomhammer
光暗物质=vật chất sáng tối
麦格瑟里德的莎柏林娜=Sabrina Magtherid
娜乌西卡=Nausicaä
马勒迪兹殿下=Maladis điện hạ
威尔士亲王=thân vương xứ Wales
卡洛斯=Carlos
加洛德.影歌=Garod Shadowsong
黛安娜=Diana
辛西娅=Cynthia
吕秀菱=Lã Tú Lăng
邵乔茵=Thiệu Kiều Nhân
张小燕=Trương Tiểu Yến
向华胜=Hướng Hoa Thắng
向华强=Hướng Hoa Cường
许小真=Hứa Tiểu Chân
葛兰大叔=chú Geran
雷诺特家=nhà Reynolds
雷诺特=Reynolds
黑旗胜=Hắc Kỳ Thắng
老布尼尔=lão Buniel
西里尔=Cyril
米尔豪斯=Millhouse
米尔豪斯.法力风暴=Millhouse Manastorm
梅特里=Meitre
海曼·马克西姆=Herman · Maxime
马克西姆=Maxime
加文拉德=Gavinrad
图拉扬=Turalyon
克莉丝汀夫人=phu nhân Christine
马尔高克=Mar'gok
艾伦伯爵=bá tước Allen
范达尔.鹿盔=Fandral Staghelm
罗秀小姐=tiểu thư Rossie
烈金雷诺特家族=gia tộc Aurum-Reynold
汪明荃=Uông Minh Thuyên
郭志良=Quách Chí Lương
许锦亨=Hứa Cẩm Hanh
许士勋=Hứa Sĩ Huân
麦当雄=Mạch Đương Hùng
樱兰罗行省=tỉnh England
罗秀的父亲=cha của Rossie
克莉丝汀姑妈=cô ngoại Christine
英雄希罗=anh hùng Heero
《骑士》小说月刊=⟨Kỵ Sĩ⟩ tiểu thuyết tạp chí tháng
惶不可终日=hoảng sợ không chịu nổi một ngày
兰特瑞索=Lantresor
汤姆.恩博=Tom Ember
耐克鲁斯=Nekros
祖鲁希德=Zuluhed
赤.裸.裸=rành ràng
惊才艳=thiên tài kinh diễm
都敏俊=Đô Mẫn Tuấn
弗斯塔德=Falstad
阿纳斯特瑞安=Anasterian
阿纳斯特瑞安.逐日者=Anasterian Sunstrider
奥蕾莉亚.风行者=Alleria Windrunner
玛里苟斯=Malygos
阿莱克斯塔萨=Alexstrasza
耐克鲁斯.碎颅者=Nekros Skullcrusher
麦克尼尔·瑟玛普拉格=Mekgineer  · Thermaplugg
克罗米=Chromie
古尔加=Guldan
千面女帝=Thiên Diện Nữ Đế
宁至燑=Ninh Chí Trùng
加拉哈德=Galahad
埃弗拉=Efra
欧阳碧桑=Âu Dương Bích Tang
努尔图=Nỗ Nhĩ Đồ
古国龙=Cổ Quốc Long
银鱼号=Cá Bạc Số
太白云生=Thái Bạch Vân Sinh
兵贵精不贵多=binh quý tinh không quý nhiều
霍尔默斯=Holmes
洛伦佐=Lorenzo
无数朵=vô số
乔大师=Kiều Đại Sư
激水之二=Kích Thuỷ chi nhị
硕亲王=Thạc thân vương
小云姑娘=tiểu vân cô nương
蝶剑仙=bướm kiếm tiên
水手沃尔=thuỷ thủ Wall
奥丁神=thần Odin
东方余亮=Đông Phương Dư Lượng
谭碧雅=Đàm Bích Nhã
罗恒深=La Hằng Thâm
维多利亚女王=nữ hoàng Victoria
曹正义=Tào Chính Nghĩa
袁红雪=Viên Hồng Tuyết
燃心丹=Nhiên Tâm Đan
德·莱奥朗=de Léoran
公关交际能力，=quan hệ xã hội giao tiếp năng lực,
佛尼姆=Fornimus
碧游涛步=Bích Du Đào Bộ
曹顺花=Tào Thuận Hoa
卡兹莫丹=Khaz Modan
图拉杨=Turalyon
边丝轩=Biên Ti Hiên
东方射=Đông Phương Xạ
大户的庄寨=trang trại của nhà giàu
姜婉姗=khương uyển san
孙湿寒=Tôn Thấp Hàn
阿隆索斯=Alonsus
法琳娜=Faerlina
傅旱彪=Phó Hạn Bưu
尼古拉=Nicolas
尚加尔涅=Changarnier
程委员=Trình uỷ viên
墨狮狂=mặc sư cuồng
纸终究包不住火=giấy không gói được lửa
恐爪马=khủng trảo mã
这三个一脑袋发财梦的位面旅行者=ba cái vị diện người lữ hành có phát tài giấc mơ một cái đầu này
暖沼谷=noãn chiểu cốc
头恐爪=đầu khủng trảo
疾鬼云=tật quỷ vân
打生抽=ngoáy nước tương
狼王大人=lang vương đại nhân
保恩王=Bảo Ân vương
哈瓦斯=Havas
陈和云=Trần Hoà Vân
灵虚丹=Linh Hư Đan
福寿章=Phúc Thọ Chương
化水而生=Hoá Thuỷ Nhi Sinh
红阳火劫=Hồng Dương Hoả Kiếp
天坏空神劫=Thiên Hoại Không Thần Kiếp
奥逊#8226;威尔斯=Orson Wells
奥迪隆=Odilon
圣阿尔诺=Saint‑Arnaud
洛洛特=Lolotte
宁回彦=Ninh Hồi Ngạn
许大统领=Hứa đại thống lĩnh
袁期阳=Viên Kỳ Dương
裴燕飞=bùi yến phi
贝草绳=Bối Thảo Thằng
太上家老=thái thượng gia lão
落魄谷=Lạc Phách Cốc
千人魂=thiên nhân hồn
麦格尼=Magni
索瑞森=Thaurissan
江暴牙=Giang Bạo Nha
杨破樱=Dương Phá Anh
严天寂=nghiêm thiên tịch
浩激流=Hạo Kích Lưu
严翠儿=Nghiêm Thuý Nhi
盐土等等=diêm thổ đẳng đẳng
小狐仙=Tiểu Hồ Tiên
血神子=huyết thần tử
拉斐特=Rafaette
三尊说=tam tôn thuyết
一言仙=nhất ngôn tiên
大不易=rất khó
古往炼道=cổ vãng luyện đạo
龙头钻=long đầu toản
风刃、水龙、拳石=phong nhận, thuỷ long, quyền thạch
老族长=lão tộc trưởng
百狼王=bách lang vương
千狼王=thiên lang vương
放过去=bỏ qua
青年蛊=thanh niên cổ
大英雄=đại anh hùng
其副手=trợ thủ Kỳ
红炎谷=hồng viêm cốc
独孤求婚=Độc Cô Cầu Hôn
黑莲教=Hắc Liên giáo
朱秀才=Chu tú tài
马和尚=Mã hoà thượng
崔有愧=Thôi Hữu Quý
薛小宝=Tiết Tiểu Bảo
德·布罗伊=de Broglie
生物柴油=xăng sinh học
皓珠蛊=Hạo Châu Cổ
剑一生=Kiếm một đại
白永升=Bạch Vĩnh Thăng
魏和麟=Nguỵ Hoà Lân
卡芬雅克=Cavaignac
蒙特斯潘=Montespan
瓦里埃尔=Vallière
洪龙敏=Hồng Long Mẫn
洪建全=Hồng Kiến Toàn
郑镇坤=Trịnh Trấn Khôn
左宏远=Tả Hoành Viễn
陈飞鹏=Trần Phi Bằng
钱水协=Tiền Thuỷ Hiệp
钱水廷=Tiền Thuỷ Đình
明老爷子=Minh lão gia tử
李老太太=Lý lão thái thái
蒋岩东=Tưởng Nham Đông
东门吹雨=Đông Môn Xuy Vũ
于东楼=Vu Đông Lâu
千代子=Chiyoko
马帮平=Mã Bang Bình
金长满=Kim Trường Mãn
张安乐=Trương An Lạc
铁白棋=Thiết Bạch Kỳ
七姨太=Thất di thái
苟布里=Cẩu Bố Lý
重泰犬=trọng thái khuyển
地灵霸龟=Địa Linh Bá Quy
云落天=Vân Lạc Thiên
李飞乐=Lý Phi Nhạc
我素蛊=ngã tố cổ
罗时闭=La Thời Bế
小晴晴=tiểu Tình Tình
于老师=Vu lão sư
铁线花=Thiết Tuyến Hoa
铁刀苦=Thiết Đao Khổ
铁傲开=Thiết Ngạo Khai
铁霸修=Thiết Bá Tu
铁慕白=Thiết Mộ Bạch
铁铉之=Thiết Huyễn Chi
白淑芬=Bạch Thục Phân
鹤风扬=Hạc Phong Dương
陆钻风=Lục Khoan Gió
无足鸟蛊=không đủ chim cổ
铁血冷=Thiết Huyết Lãnh
太日阳莽=Thái Nhật Dương Mãng
胡灵儿=hồ Linh Nhi
路易·波拿巴=Louis Bonaparte
约瑟夫·波拿巴=Joseph Bonaparte
韦绮珊=Vi Ỷ San
陈慧娴=Trần Tuệ Nhàn
贺震旦=Chúc Chấn Đán
魏良荣=Nguỵ Lương Vinh
梅爱芳=Mai Ái Phương
白素芬=Bạch Tố Phân
周金瑞=Chu Kim Thuỵ
许晴舒=Hứa Tình Thư
袁秋实=Viên Thu Thực
狗胆蛊=cẩu đảm cổ
卓修贤=Trác Tu Hiền
薛三四=Tiết Tam Tứ
嘎子掖=Khiết Tử Dịch
杜伦农=Đỗ Lennon
于钿秋=Vu Điền Thu
杜岐山=Đỗ Kỳ Sơn
程黛幽=Trình Đại U
于之璇=Vu Chi Toàn
任三宝=Nhậm Tam Bảo
蒋千沁=Tưởng Thiên Thấm
寄魂蚤。=ký hồn tảo.
千兽王=thiên thú vương
孙元化=Tôn Nguyên Hóa
的三酸二碱=ba acid hai soda
季思退=Quý Tư Thối
苟循礼=Cẩu Tuần Lễ
苟循义=Cẩu Tuần Nghĩa
左禅玉=tả thiền ngọc
车巧香=xa xảo hương
前不着村后不着店=trước không thôn sau không tiệm
风雨楼=Phong Vũ Lâu
叶倩文=Diệp Thiến Văn
腾灸龙=đằng cứu long
商赑屃=Thương Bí Hý
商狻猊=thương Toan Nghê
活宝门=Hoạt Bảo Môn
铁钳黑甲=kìm sắt hắc giáp
商睚眦=Thương Nhai Tí
张心慈=Trương Tâm Từ
商螭吻=Thương Ly Vẫn
骨肉团圆=Cốt Nhục Đoàn Viên
上达天听=tấu lên trên
王瑞相=Vương Thuỵ Tương
商燕飞=Thương Yến Phi
李立君=Lý Lập Quân
张国中=Trương Quốc Trung
林全安=Lâm Toàn An
飞骨盾=Phi Cốt Thuẫn
剑影蛊=Kiếm Ảnh Cổ
刀光蛊=Đao Quang Cổ
刘老香=Lưu Lão Hương
姜大成=Kang Dae-sung
冯乃歆=Phùng Nãi Hâm
冯乃凯=Phùng Nãi Khải
顾英德=Cố Anh Đức
周绍昆=Chu Thiệu Côn
吴大令=Ngô đại lệnh
左宏元=Tả Hoành Nguyên
符巡检=Phù tuần kiểm
周蓝萍=Chu Lam Bình
邬德同志=Ô Đức đồng chí
多宝真仙=Đa Bảo chân tiên
黄亚生=Hoàng Á Sinh
螺旋骨枪=Xoắn Ốc Cốt Thương
三百一十=ba trăm mười
黑白豕蛊=Hắc Bạch Thỉ Cổ
文慨伟=Văn Khái Vĩ
司马翎=Tư Mã Linh
卧龙生=Ngọa Long Sinh
刘兆玄=Lưu Triệu Huyền
张童生=Trương học trò nhỏ
宋霭龄=Tống Ái Linh
天台帮=Thiên Thai bang
招关起=Chiêu Quan Lên
茅如松=Mao Như Tùng
方天民=Phương Thiên Dân
秦详林=Tần Tường Lâm
李朋飞=Lý Bằng Phi
谭小芹=Đàm Tiểu Cần
席首长=Tịch thủ trưởng
谭老伯=Đàm lão bá
吴为建=Ngô Vi Kiến
单于雄=Đơn Vu Hùng
奥格瑞姆=Orgrim
付立兢=Phó Lập Cảng
达索汉=Dathrohan
香克斯=Shanks
提里奥=Tirion
古尔蛋=Gul’dan
赫尼马雷布=Henry Maleb
达纳斯=Danath
成晴哥=Thành Tình ca
李俊生=Lý Tuấn Sinh
安达充=Adachi
郑智化=Trịnh Trí Hoá
惠英虹=Huệ Anh Hồng
惠天赐=Huệ Thiên Tứ
江之文=Giang Chi Văn
张冰倩=Trương Băng Thiến
关之纪=Quan Chi Kỷ
关佳慧=Quan Giai Tuệ
荀训阳=Tuân Huấn Dương
苟训阳=Cẩu Huấn Dương
霍万秋=Hoắc Vạn Thu
李毅成=Lý Nghị Thành
戴玉芬=Đới Ngọc Phân
傅崇碧=Phó Sùng Bích
苟大家=Cẩu đại gia
霍元甲=Hoắc Nguyên Giáp
黎燕珊=Lê Yến San
塔娜鞠=Tháp Na Cúc
孙大迁=Tôn Đại Thiên
汪仲涵=Uông Trọng Hàm
冯炳仲=Phùng Bính Trọng
宋慧珍=Tống Tuệ Trân
林正英=Lâm Chính Anh
施南笙=Thi Nam Sênh
常凯申=Thường Khải Thân
金克绶=Kim Khắc Thụ
李元元=Lý Nguyên Nguyên
李一挝=Lý Nhất Qua
托贝斯克=Tobesk
王小美=Vương Tiểu Mỹ
斯威诺=Swinno
邬语蓉=Ô Ngữ Dung
贺诗琴=Hạ Thi Cầm
董元涛=Đổng Nguyên Đào
董亓涛=Đổng Kỳ Đào
李茂仁=Lý Mậu Nhân
穆芋芋=Mục Thiên Thiên
穆芊芋=Mục Thiên Thiên
穆芋芋不=Mục Thiên Thiên
孟军豪=Mạnh Quân Hào
苏瑞文=Tô Thuỵ Văn
马婷婷=Mã Đình Đình
马家伟=Mã Gia Vĩ
马慧芳=Mã Tuệ Phương
汤德阳=Canh Đức Dương
临渊不羡鱼=Lâm Uyên Bất Tiễn Ngư
闯、献=Xông, Hiến
姚红林=Diêu Hồng Lâm
谭天晴=Đàm Thiên Tình
谭桂璜=Đàm Quế Hoàng
谭桂琼=Đàm Quế Quỳnh
谭成晴=Đàm Thành Tình
羊大户=Cừu đại hộ
狗大户=Cẩu đại hộ
苏去人=Tô Khứ Nhân
苏若依=Tô Nhược Y
有了基地之后=có căn cứ về sau
展老板=Triển ông chủ
秦仁伯=Tần Nhân Bá
詹秀梅=Chiêm Tú Mai
詹建义=Chiêm Kiến Nghĩa
井眸幼=Tỉnh Mâu Ấu
机械厂=cơ giới nhà máy
机器猫=Mèo Máy
苏漬影=Tô Thanh Ảnh
苏清影=Tô Thanh Ảnh
搞不清=không biết rõ
刘铁生=Lưu Thiết Sinh
降龙无悔=Giáng Long Vô Hối
陶曼影=Đào Mạn Ảnh
彭晓云=Bành Hiểu Vân
穆四海=Mục Tứ Hải
万建民=Vạn Kiến Dân
鲁广年=Lỗ Quảng Niên
刘彩秀=Lưu Thải Tú
苏晨怡=Tô Thần Di
沈光年=Thẩm Quang Niên
王起顺=Vương Khởi Thuận
李若泰=Lý Nhược Thái
丁瑞龙=Đinh Thuỵ Long
福建沿海=Phúc Kiến vùng duyên hải
李若冰=Lý Nhược Băng
一千四百一十七=1,417
苟大户=Cẩu đại hộ
很有兴趣的问题=rất có hứng thú vấn đề
文老爷=Văn lão gia
高露洁=Cao Colgate
高大姐=Cao đại tỷ
门之匙=Môn Chi Thi
泰尔斯·璨星=Tyres · Starbright
埃克斯特=Eckstedt
查曼·伦巴=Chapman · Rumba
辛迪亚=Sindia
夜何极=Dạ Hà Cực
谭村长=Đàm thôn trưởng
符奥雅=Phù Áo Nhã
丹弥夜=Đan Di Dạ
朱峒主=Chu động chủ
方庭凌=Phương Đình Lăng
这个朱=cái này Chu
纸仙道=Chỉ Tiên đạo
神威派=Thần Uy phái
特意准备=cố ý chuẩn bị
无二清=Vô Nhị Thanh
南北宋=Nam Bắc Tống
金明远=Kim Minh Viễn
王有德=Vương Hữu Đức
顾天明=Cố Thiên Minh
鬼神之力=sức mạnh quỷ thần
海贼队伍=hải tặc đội ngũ
古怪的队伍=cổ quái đội ngũ
陆亦鸣=Lục Diệc Minh
叶金波=Diệp Kim Ba
卢瑞松=Lư Thuỵ Tùng
薛青山=Tiết Thanh Sơn
九天荡魔=Cửu Thiên Đãng Ma
秦李氏=Tần Lý Thị
秦道仁=Tần Đạo Nhân
王菊金=Vương Cúc Kim
钟振涛=Chung Chấn Đào
秦祥麟=Tần Tường Lân
松阪庆子=Matsusaka Keiko
真田广之=Sanada Hiroyuki
贾静文=Giả Tịnh Văn
虞勘平=Ngu Khám Bình
段文辉=Đoạn Văn Huy
吴少刚=Ngô Thiếu Cương
刘瑞琪=Lưu Thuỵ Kỳ
麻兰英=Ma Lan Anh
张乐源=Trương Nhạc Nguyên
方逸华=Phương Dật Hoa
李天胜=Lý Thiên Thắng
谭永麟=Đàm Vĩnh Lân
丁文秀=Đinh Văn Tú
珊蒂斯.羽月=Shandris Feathermoon
珊蒂斯=Shandris
成魁安=Thành Khôi An
沙德拉=Shadra
钟凌秀=Chung Lăng Tú
俞咨皋=Du Tư Cao
福建总兵=Phúc Kiến tổng binh
沙德拉洛=Shadra'Alor
约格萨隆=Yogg-Saron
戈隆战争领主=Gronn warlord
博尼格托.淬火者=Bonigoto Quencher
库德兰=Kurdran
达纳斯.贝尔托恩=Danath Trollbane
赫尼.马雷布=Henry Maleb
陆队长=Lục đội trưởng
法石禄=Pháp Thạch Lộc
白少岳=Bạch Thiếu Nhạc
同荀和=Đồng Tuân Hoà
关之琳=Quan Chi Lâm
柳絮剑法=Liễu Nhứ Kiếm Pháp
羽青丹=Vũ Thanh Đan
燕冰玉=Yến Băng Ngọc
燕飞云=Yến Phi Vân
铁前辈=Thiết tiền bối
铁姑娘=Thiết cô nương
铁蓉蓉=Thiết Dung Dung
鹤无声=Hạc Vô Thanh
月师兄=Nguyệt sư huynh
月千愁=Nguyệt Thiên Sầu
高过人头的荒草的草地=bãi cỏ của cỏ dại cao hơn đầu người
薛归月=Tiết Quy Nguyệt
护卫队伍=hộ vệ đội ngũ
野外活动=dã ngoại hoạt động
户外运动=ngoài trời vận động
谢烟客=Tạ Yên Khách
狗杂种=Cẩu Tạp Chủng
摩天居士=Ma Thiên cư sĩ
黄天霸=Hoàng Thiên Bá
涂大哥=Đồ đại ca
涂有才=Đồ Hữu Tài
纪海棠=Kỷ Hải Đường
吴行藏=Ngô Hành Tàng
温如言=Ôn Như Ngôn
金顶九式=Kim Đỉnh cửu thức
叶无断=Diệp Vô Đoạn
傅英云=Phó Anh Vân
纪小棠=Kỷ Tiểu Đường
纪凡尘=Kỷ Phàm Trần
柳素心=liễu Tố Tâm
青煞诀=Thanh Sát Quyết
狼月刀法=Lang Nguyệt Đao Pháp
吴祖鹰=Ngô Tổ Ưng
薛万里=Tiết Vạn Lý
薛承贤=Tiết Thừa Hiền
褚定荣=Chử Định Vinh
李凡宇=Lý Phàm Vũ
郑芝龙=Trịnh Chi Long
李魁奇=Lý Khôi Kỳ
俞督帅=Du đốc soái
市场上批发=trên thị trường bán sỉ
钱德多=Tiền Đức Đa
伊米尔=Ymir
当地的黎情=người Lê tình hình địa phương
吴首长=Ngô thủ trưởng
混合米的=hỗn hợp gạo
王状元=Vương Trạng Nguyên
中国人民=nhân dân Trung Quốc
机械组=bộ cơ giới
萧白郎同志=Tiêu Bạch Lang đồng chí
萧白郎=Tiêu Bạch Lang
萨琳娜=Serena
穆芊芊=Mục Thiên Thiên
胡义成=Hồ Nghĩa Thành
花纸头=hoa giấy
饭菜票=đồ ăn phiếu
秦少游=Tần Thiểu Du
工分制度=công điểm chế độ
邬老爷=Ô lão gia
符有地=Phù Hữu Địa
美第奇=Medici
英诺森=Innocent
施底肥=cho phân bón lót
玛利.曼奇尼=Marie . Mancini
保险起见=để bảo hiểm
利亚德=Leyard
碧鱼儿=Bích Ngư Nhi
尹铁生=Doãn Thiết Sinh
极道门=Cực Đạo môn
星衍宫=Tinh Diễn cung
墨蛟仙子=Mặc Giao tiên tử
尹飘飘=Doãn Phiêu Phiêu
千莽草原=Thiên Mãng thảo nguyên
柳飞絮=Liễu Phi Nhứ
七色童子=Thất Sắc Đồng Tử
莫归虚=Mạc Quy Hư
血衣门=Huyết Y Môn
李碧华=Lý Bích Hoa
叶雨铭=Diệp Vũ Minh
大豆、绿豆、赤豆、黑豆=đậu nành, đậu xanh, đậu đỏ, đậu đen
工业部门=ngành công nghiệp
兔子之类的畜禽=con thỏ các loại gia súc gia cầm
杨宝贵=Dương Bảo Quý
杨兽医=Dương bác sỹ thú y
吴南海=Ngô Nam Hải
又肥又嫩=lại béo lại mềm
这猪的品种=chủng loại lợn này
猪身上=trên người lợn
阿历克斯.巴罗夫=Alexi Barov
卡洛斯.巴罗夫=Carlos. Barov
索拉丁=Thoradin
骡马院=chuồng ngựa
租得濠镜澳=thuê được Macao
贸易门户=buôn bán cửa ngõ
眩晕的感觉=cảm giác chóng mặt
手中的温州产打火机=trong tay Ôn Châu sản cái bật lửa
答应回礼=đáp lễ
愤懑之情=phẫn uất cảm xúc
下得了手=hạ thủ được
买房子的事情=mua phòng ốc sự việc
海贸的商人=trên biển buôn bán thương nhân
社会性组织内=trong xã hội tính tổ chức
工作的文德嗣=công tác Văn Đức Tự
民主权力的现代人=dân chủ quyền lực người hiện đại
组织等等=tổ chức vân... vân
冲个澡=tắm một cái
一切事务=hết thảy sự vụ
熟悉的同事=quen thuộc đồng sự
韭菜根=gốc rau hẹ
时间久=thời gian lâu dài
一头牛=một con trâu
薛唯尼=David Tiết
席头目=Tịch đầu mục
于鄂水=Vu Ngạc Thuỷ
什么农业=cái gì nông nghiệp
巴罗夫=Barov
伊露西亚=Illucia
杜隆坦=Durotan
古伊尔=Go'el
匹瑞诺德=Perenolde
泰瑞纳斯=Terenas
17世纪的中=trong thế kỷ 17
种橡胶=trồng cao su
什么大炮=cái đại bác gì
各方面=các phương diện
无数现代的工具和用品=vô số công cụ cùng đồ dùng hiện đại
这些野心=chút này dã tâm
实在太近=quả thực quá gần
潮水般=như thuỷ triều
相抗衡=chống lại
也许能=e rằng có thể
批量化=số lượng lớn
钛铁矿=quặng titan
四百一十万亩=bốn trăm mười vạn mẫu
编户齐民数十万的南陲=nhập hộ khẩu mười vạn dân số biên giới phía nam
编户齐民数十万=nhập hộ khẩu mười vạn dân số
程度上=trong trình độ
一定程度上=trong trình độ nhất định
荷兰人=người Hà Lan
山川河海之险=sông núi nước non hiểm trở
统治的核心区域=thống trị khu vực nòng cốt
良好的农业=hài lòng nông nghiệp
战略游戏的一个关键=một cái mấu chốt chiến lược của trò chơi
会议室的桌子旁=bên cạnh phòng họp cái bàn
下面做=tiếp theo làm
一辆老款的切诺基=một chiếc đời cũ Cherokee
席亚洲=Tịch Châu Á
好多勒索=nhiều hơn sách nhiễu
扣留了=giảm giữ
张兴福=Trương Hưng Phúc
·大和=· Yamato
希尔科斯=Hilkos
佩里娅=Perria
气了个半死=tức gần chết
刘进士=Lưu tiến sĩ
刘大霖=Lưu Đại Lâm
黄守统=Hoàng Thủ Thống
王田的队伍=Vương Điền đội ngũ
展无涯=Triển Vô Nhai
俘虏的土著=bản xứ tù binh
黄土、石灰和水=đất vàng , vôi cùng nước
临高城=Lâm Cao thành
一纸辞书=một giấy từ chức
经理的头衔=danh hiệu giám đốc
这会已经被公司=đã hồi cũ công ty
花了二万代=hoa hai vạn
办个公司=sáng lập cái công ty
马行家=Mã người trong nghề
这样一个盘子=dạng này một cái đĩa
的得意劲=đắc ý dáng vẻ
成交率=thành giao tỷ lệ
不算大=coi như không ớn
这盘子=đĩa này
如果是真得=nếu như là thực
那应该是真得=kia hẳn phải là thật
应该是真得=hẳn phải là thật
的出窑不久的新货=mới ra lò không lâu hàng
火气未褪=nhiệt lượng chưa rút
这个盘子=cái đĩa này
从哪里=từ nơi nào
那这个瓷盘=kia cái bàn sứ này
纹样里=kiểu dáng hoa văn bên trong
在盘、碗的口沿=tại ven miệng của mâm, bát
在盘、碗的口=tại miệng của mâm, bát
马教授=Mã giáo sư
旅行箱=túi du lịch
怎么会多=thế nào sẽ thêm
熔炼了一下=nấu chảy một phát
不够纯=không đủ tinh khiết
此事的家丁=chuyện này đầy tớ
海商的事情=hải thương sự việc
连请他来=liền đến mời hắn
不领行情=không biết giá thị trường
几大篓=mấy sọt lớn
明万历=Minh Vạn Lịch
捞上来=mò lên
打捞上来=mò vớt lên
stensjostrand=Sten Sjostrand
出口用=xuất khẩu dùng
其中一千五两用黄金=một ngàn rưỡi lượng dùng hoàng kim trong đó
两用黄金=lượng dùng Hoàng Kim
高举命=Cao Cử lệnh
货款按=tiền hàng theo
装油的方法=thêm dầu phương pháp
的话茬=đề tài
极大的好处=chỗ tốt cực lớn
一个昂贵的玻璃罩子=một cái sang quý lồng thuỷ tinh cái chụp
大小的=lớn bé
未来的穿越计划=xuyên qua tương lai kế hoạch
现代社会的煤油灯=hiện đại xã hội đèn dầu hoả
会惊讶的东西=sẽ sửng sốt đồ vật
社会的煤油灯=xã hội đèn dầu hoả
奥杜因=Alduin
莫不目瞪口呆=không người không trợn mắt há mồm
倒进去=đổ vào
听煤油=hộp dầu hoả
一听煤油=một lon dầu hoả
花了他们不少时间=tốn bọn hắn không ít thời gian
缎的袍子=áo choàng gấm
昏惨惨的烛光下=dưới ánh nến mờ mờ ảo ảo
高大倌人=Cao đại quan nhân
纸箱子=thùng giấy con
什么鬼魅=cái ma quỷ
得的拍卖=có được đấu giá
这个范畴内=trong cái phạm trù này
这些粉盒=những hộp phấn này
召开了=tổ chức
克拉克瓷=sứ Clark
代替一下=thay thế một cái
之旅的三个人=hành trình của ba người
王世贞=Vương Thế Trinh
已经廖然=đã là
17世纪的价格=giá cả của thế kỷ 17
后院的一所僻静=hậu viện một chỗ yên lặng
犯了很大的嘀咕=đụng rất lớn e sợ
澳洲海商”们=châu Úc hải thương” nhóm
新奇之物=mới lạ đồ vật
谈妥了=đàm luận thỏa đáng
起身告辞=lên đường cáo từ
国有一主=quốc chủ có một
每以名目=thường hay lấy tên
好空谈=thích đàm luận
奇巧之货=hàng hóa tinh xảo
多奇巧之货=nhiều hàng hóa tinh xảo
麦丽丽=Mạch Lệ Lệ
本国尚蓝=nước mình tôn sùng màu xanh
多能工巧匠=nhiều người giỏi tay nghề
雨衣和小刀=áo mưa cùng dao nhỏ
只是好在轻便不碎上=chỉ là còn may nhẹ nhàng không vỡ được
刘松壬=Lưu Tùng Nhâm
几百年的见识=mấy trăm năm kiến thức
杜其峰=Đỗ Kỳ Phong
这些濠畔街的商人=cái này thương nhân Hào Bờ phố
他们的小镜=gương nhỏ của bọn hắn
钟楚红=Chung Sở Hồng
后世的文献中=trong tài liệu lịch sử của đời sau
专营出口=chuyên doanh xuất khẩu
刘秋生=Lưu Thu Sinh
商品的看法=thương phẩm cái nhìn
这广州的海贸之事=Quảng Châu buôn bán trên biển chuyện
这广州的海=biển Quảng Châu này
塑料小粉盒=nhựa dẻo hộp phấn nhỏ
商人的胃口=thương nhân khẩu vị
不怎么起眼的塑料小粉盒=không thế nào thu hút nhựa dẻo hộp phấn nhỏ
不怎么起眼的塑料=không thu hút thế nào nhựa dẻo
一千两成=hai nghìn lượng thành
每件一钱=mỗi kiện một chỉ
密胺的碗碟=a-min mật bát đĩa
贵处的行情=giá thị trường chỗ quý
杨青青=Dương Thanh Thanh
这等玻璃器具=này pha lê đồ
等玻璃器具=pha lê đồ
惯用的奇货=quen dùng kỳ lạ hàng hóa
这些奇货=chút kỳ lạ hàng hóa này
佛郎机人=người Franco
这伙人=đám người này
张叔屏=Trương Thúc Bình
一转手=chuyển tay một cái
叶锦天=Diệp Cẩm Thiên
不会透水的料子=không thấm nước chất liệu
不会透水=không thấm nước
一些闪闪发亮的小刀=một chút dao nhỏ toả sáng lập loè
一些透明的盒子=một ít cái hộp trong suốt
这些人的东西=chút người này đồ vật
转了几个圈子=lăn mấy cái vòng tròn
摔得四分五裂=bị rơi vỡ chia năm xẻ bảy
一回事=một chuyện
这个杯子=cái cốc này
些好看的图案=chút dễ coi đồ án
这些人的货物=chút này người hàng hoá
覆灭的道路=con đường huỷ diệt
这个汉人最后的中原王朝=cái này Trung Nguyên cuối cùng người Hán vương triều
汉人最后的中原王朝=Trung Nguyên cuối cùng người Hán vương triều
一个烂疮=một cái vết loét
给晚明的政治=cho cuối đời Minh chính trị
踏上了末路=bước đến đường cùng
权倾一时的九千岁的踏上了末路=nhất thời quyền nghiêng Cửu Thiên Tuế bước đến đường cùng
权倾一时的九千岁=nhất thời quyền nghiêng Cửu Thiên Tuế
楼楠光=Lâu Nam Quang
许贯英=Hứa Quán Anh
皇太极=Hoàng Thái Cực
的海东藩属=phiên thuộc Hải Đông
这几个人身=mấy cái người này thân
廖启智=Liêu Khải Trí
许文强=Hứa Văn Cường
拱手之礼=lễ chắp tay
通洋之船=thuyền đi Tây
洪金宝=Hồng Kim Bảo
好几百年前的事情=hơn mấy trăm năm trước sự tình
许冠英=Hứa Quán Anh
并不是=tuyệt không phải
外国船的意思=ý tứ thuyền của ngoại quốc
所预计=dự tính
一个说法=một cái cách nói
钟镇涛=Chung Trấn Đào
进的城=vào thành
愈发大胆起来=càng to gan hơn
愈发大胆=càng to gan
插话道=xen vào nói
不满意的插话道=không hài lòng xen vào nói
不满意=không hài lòng
怎会是=sao sẽ là
不容于我=không dung chúng ta
崖山之后=xuống dốc về sau
赵雅芝=Triệu Nhã Chi
听出来=suy đoán ra
粗布衣=chất vải thô
淡淡一缕胡须=một chòm râu lờ mờ
变换不定=biến hoá không ngừng
龙阳之好=thích thú long dương
这样一个男人=dạng này một cái nam nhân
正疑惑着=đang lúc nghi hoặc
倒退了=lùi lại rồi
什么路数=cái nội tình gì
观其神情=xem thần sắc họ
养尊处优之人=sống trong nhung lụa người
看其样貌=xem hình dạng họ
六尺之躯=sáu thước thân cao
不粗大=không thô to
这身装扮=thân này ăn mặc
短不及=ngắn không tới
常见的髡发=thường gặp tóc ngắn
见上一见=nhìn xem một cái
既然对方能=Nếu như đối phương có thể
唐船贩运=vận đường thuyền
转念一想=nghĩ lại
日本国内哪位名主的使者=sứ giả của vị lãnh chúa danh tiếng nào trong nước Nhật Bản
名主的使者=tên sứ của vị lãnh chúa danh tiếng
莫非是=chẳng lẽ không phải là
日本国内=trong nước Nhật Bản
只出在一城=chỉ sản xuất tại một thành phố
这些年来=những năm gần đây
真真正正的大明之人那=chân chân chính chính Đại Minh người đấy
大明之人那=Đại Minh người đấy
心平了些=tronh lòng bình tĩnh chút
拿出来=lấy ra
起了歹念=nổi lên ý đồ xấu
小心就是=nhất định cẩn thận
本时空=thời không gốc
个好价钱=cái giá tốt
会不会是圈套=có thể hay không là cái bẫy
他们会不会是圈套=có thể hay không là cái bẫy của bọn hắn
如此之大=như thế lớn
会不会=có thể hay không
连说带比=nói kèm điệu bộ
自胆边生=tự sinh trong gan
想到这里=nghĩ đến chỗ này
何谈以后=nói gì sau này
中华的大业=Trung Hoa nghiệp lớn
不就就此=chưa ra cái gì liền
时空倒爷的生涯=thời không nhà buôn kiếp sống
对峙片刻=giằng co trong phút chốc
倒爷的生涯=nhà buôn kiếp sống
条狗的下场=con chó kết cục
马运生=Mã Vận Sinh
给吓得=bị doạ đến
慌的都=Hoảng đến độ
想好的一篇开场白=nghĩ tốt một bài lời dạo đầu
里论及=lý luận đến
古代的火器=vũ khí nóng cổ đại
第一遭=lần đầu tiên gặp
黑洞洞的鸟铳对着=súng tối om om chiếu hướng
黑洞洞的鸟铳=súng tối om om
异时空的人=người ở dị thời không
一脑袋发财梦的位面旅行者=vị diện người lữ hành có phát tài giấc mơ một cái đầu
发财梦的位面旅行者=vị diện người lữ hành có phát tài giấc mơ
位面旅行者=thời không người lữ hành
发财梦的位面=phát tài giấc mơ vị diện
院门一开=cửa viện vừa mở ra
门一开=cửa vừa mở ra
扑上来=nhào lên
反手一抄=trở tay một phát
划一开始就出了问题=bắt đầu liền ra vấn đề đồng loạt
划一开始=bắt đầu đồng loạt
从刚才到现在=từ vừa nãy đến bây giờ
那电击器=khẩu súng điện kia
刚才到现在=vừa nãy đến bây giờ
基连·扎比=Gihren  · Zabi
通番货洋发的财=thông qua hàng Tây phát tài
佛郎机人手里=trong tay người Franco
货洋发的财=hàng Tây phát tài
纸盒子=hộp giấy nhỏ
上了一层釉=phủ một tầng men
半信半疑间=trong lúc bán tín bán nghi
米诺夫斯基=Minovsky
看他们的模样=xem bọn hắn bộ dáng
伊奥利亚·修罕贝克=Aeolia  · Schenberg
看了一眼=xem qua một mắt
格雷米=Glemy
天田士郎=Shirou Amada
露雪特=Lucette
奥德比=Audevie
阿姆罗·雷=Amuro  · Ray
赶紧着=vội vàng gấp rút
桂治洪=Quế Trị Hồng
原先叫=trước tiên kêu
寇掠沿海的往事=cướp đoạt vùng duyên hải chuyện cũ
早年间=thời trẻ
汪老大=Uông Lão Đại
的汪老大=Uông lão đại
几个弯=vài vòng
的挥了下袖子=vung tay áo ra sau
挥了下袖子=vung tay áo ra sau
不凡的挥了下袖子=bất phàm vung tay áo ra sau
绑了关=trói nhốt
是只要是=nếu như chỉ là
重重一顿=một đòn nặng nề
眯缝着=lim dim
他的身家=cà nhà của hắn
杨公公=Dương công công
九千岁=Cửu Thiên Tuế
禁止出口的硝石和铁器=cấm chỉ xuất khẩu tiêu thạch cùng đồ sắt
禁止出口=cấm chỉ xuất khẩu
佛郎机=Franco
发的财=phát tài
最得宠的小妾=tiểu thiếp được sủng ái nhất
诡异的光=quỷ dị ánh sáng
那栈院本身=Bản thân Viện kia
什么异样=cái gì khác thường
三个人来=đến ba người
三个人=ba người
明清二代=Minh Thanh hai đời
这几个奇装异服的人=mấy cái người mặc kỳ dị trang phục này
17世纪的古人=người xưa của thế kỷ 17
之后会=về sau sẽ
灰砖瓦房=xám phòng gạch ngói
撞大运=tìm vận may
钱家豪=Tiền Gia Hào
一个房间=một cái căn phòng
趣味和需求=hứng thú cùng nhu cầu
二天份=hai ngày đơn vị
电击器=súng điện
防刺背心=giáp phòng đâm
又搞了=lại lấy ra
一些烟幕弹=một it đạn khói
慎重起见=Vì thận trọng
比力气=so đo sức lực
想了下=nghĩ về sau
的全钢弩机和猎刀=bằng thép cung nỏ cùng dao đí săn
全钢弩机=bằng thép cung nỏ
随身携带=mang theo người
祝熙瑞=Chúc Hy Thuỵ
快干服=câp tốc vận động trang phục
高举之惑=nghi hoặc của Cao Cử
最适合=thích hợp nhất
不会在乎=sẽ không để bụng
官面背景的人物=thân quan bối cảnh nhân vật
濠畔街=Hào Bờ phố
得查查=phải điều tra thêm
海珠区=Hải Châu Khu
外国友人=ngoại quốc bạn bè
夏天冬天各=mỗi mùa hè mùa đông
广交会=quảng giao hội
这会朝廷=này sẽ khiến triều đình
那会早=kia đã sớm
几个考据=mấy cái đã qua khảo chứng
打了个冷战=rùng mình một cái
个冷战=cái lạnh run
其被俘=hắn bị bắt
来华葡萄牙人的回忆录=hồi ký của người Bồ Đào Nha đến Trung Hoa
个倒霉的葡萄牙=cái xui xẻo Bồ Đào Nha
葡萄牙人的回忆录=hồi ký của người Bồ Đào Nha
脱层皮=lột da
得脱层皮=bị lột da
祝大小姐=Chúc đại tiểu thư
不会给=không biết bị
地广人稀的地方=địa phương đất rộng người thưa
市舶司=thị thuyền vụ sở
给当成=bị xem thành
一到城门口=vừa đến cửa thành
激动的血压=kích động huyết áp
不就是=không phải chính là
闪闪发亮的金子=vàng kim toả sáng lập loè
小商品=tiểu thương phẩm
有三四箱子=tới ba bốn rương
大量促销赠品=lượng lớn quà tặng khuyến mãi
促销赠品=quà tặng khuyến mãi
王霸之旅的=hành trình của Bá Vương
第一桶金=món tiền đầu tiên
玻璃镜=pha lê gương
多到哪里去=nhiều đến được mức nào
联系之用=dùng làm liên lạc
周庭韵=Tuần Đình Vận
曾行锐=Tằng Hành Nhuệ
穿越众=người xuyên việt
第一号=số một
无主之物=vật vô chủ
灵格斯=Lingoes
会带来=sẽ mang đến
新闻中=trong tin tức
他们中=trong bọn hắn
想应该=nghĩ có thể
天启三年之=khoảng Thiên Khải ba năm
第二年=năm thứ hai
二年之后=hai năm sau
最晚近=tiếp cận cổ nhất
演绎下=biểu hiện ra
血肉模糊=máu thịt be bét
拍摄的照片=ảnh chụp được
第二印象=ấn tượng thứ hai
第一印象=ấn tượng đầu tiên
说起来=kể đến đấy
还真玄=còn thật đen
一些相当血淋淋的照片=một chút tấm ảnh chụp tương đối máu chảy đầm đìa
有可以=ở đâu có thể
一个世界的彩票=một cái thế giới vé số
这一点=một bấm này
点了帖子=bấm vào bài viết
吴克照=Ngô Khắc Chiếu
方越候=Phương Việt Hầu
祝副总指挥=Chúc phó tổng chỉ huy
方越侯=Phương Việt Hầu
第一批=nhóm đầu tiên
卫生间里=trong phòng vệ sinh
盥洗室的一面镜子=phòng vệ sinh cái gương một mặt
不同之处=chỗ bất đồng
早木冬雨=Sớm Mộc Đông Mưa
清野澪=Thanh Dã Linh
小原由美=Tiểu Nguyên Do Mỹ
之细腻=tỉ mỉ
方副总指挥=Phương phó tổng chỉ huy
圣樱学院=Thánh Anh học viện
早木同学=Tảo Mộc đồng học
早木冬雪=Tảo Mộc Đông Tuyết
北辰秀一=Bắc Thần Tú Nhất
只不过是一=bất quá chỉ là một
圣人望气=Thánh Nhân Vọng Khí
明朝的虫洞=Minh triều wormhole
第二十次=lần thứ hai mươi
那伙人=đám người kia
冷门的书=sách báo ít người đọc
古书的前辈=sách cổ tiền bối
南婉儿=Nam Uyển Nhi
文德嗣=Văn Đức Tự
楚天恩=Sở Thiên Ân
方教授=Phương giáo sư
霍教授=Hoắc giáo sư
汤振宗=Thang Chấn Tông
苏小璐=Tô Tiểu Lộ
彭教授=Bành giáo sư
暗能量场=trường năng lượng tối
方副总指挥长=Phương phó tổng chỉ huy trường
郑为波=Trịnh Vi Ba
叶其胜=diệp kỳ thắng
孙教授=Tôn giáo sư
幽灵骑士=Ghost Rider
蓝潮音=Lam Triều Âm
蓝朝音=Lam Triều Âm
楚先生=Sở tiên sinh
祁春旺=Kỳ Xuân Vượng
清渊湖海无量瓶=Thanh Uyên Hồ Hải Vô Lượng bình
展夜雨=Triển Dạ Vũ
晨光明月紫金铃=Thần quang minh nguyệt tử kim linh
潘迎紫=Phan Nghinh Tử
傅燎原=Phó Liêu Nguyên
段大年=Đoạn Đại Niên
天剑子=Thiên Kiếm tử
吉布哈=Gibha
宁海王=Ninh Hải vương
陆鑫红=Lục Hâm Hồng
田洋洋=Điền Dương Dương
俞长空=Du Trường Không
姜雨薇=Khương Vũ Vi
杨轻眉=Dương Khinh Mi
三浦蓝=Miura Ran
红导师=Hồng đạo sư
千岛花=Chishima Hana
黑羽君=Kuroha-kun
万里怜=Banri Rin
黑羽明理=Kuroha Akari
索尼娅=Sonia
泰尔斯=Tyres
燕若江=Yến Nhược Giang
许照日=Hứa Chiếu Nhật
夏小花=Hạ Tiểu Hoa
秦照月=Tần Chiếu Nguyệt
杨大局长=Dương đại cục trưởng
陈道阳=Trần Đạo Dương
陈爱英=Trần Ái Anh
夏老师=Hạ lão sư
石警官=Thạch cảnh quan
夏启元=Hạ Khải Nguyên
刘奶奶=Lưu nãi nãi
高德海=Cao Đức Hải
马小宝=Mã Tiểu Bảo
高老板=Cao lão bản
杨兴国=Dương Hưng Quốc
方小小=Phương Tiểu Tiểu
王警官=Vương cảnh quan
夏启年=Hạ Khải Niên
柳生雪姬=Liễu Sinh Tuyết Cơ
张益达=Trương Ích Đạt
华小花=Hoa Tiểu Hoa
钱问江=Tiền Vấn Giang
杨~星~月~同~学~=Dương ~ Tinh ~ Nguyệt ~ đồng ~ học ~
杨~星~月=Dương ~ Sao ~ Trăng
高富业=Cao Phú Nghiệp
高佳佳=Cao Giai Giai
杨星月=Dương Tinh Nguyệt
岳绮花=Nhạc Khởi Hoa
徐智海=Từ Trí Hải
赵黄蓉=Triệu Hoàng Dung
山河蠹=Sơn Hà Đố
张大官人=Trương đại quan nhân
江灵璇=Giang Linh Toàn
李思源=Lý Tư Nguyên
张小飞=Trương Tiểu Phi
朱无视=Chu Vô Thị
魏文彬=Nguỵ Văn Bân
夏鸿卓=Hạ Hồng Trác
李守中=Lý Thủ Trung
白大小姐=Bạch đại tiểu thư
高媛媛=Cao Viện Viện
白素青=Bạch Tố Thanh
阮清玉=Nguyễn Thanh Ngọc
吴观海=Ngô Quan Hải
齐云格=Tề Vân Cách
孟筱萱=Mạnh Tiêu Huyên
刘亚民=Lưu Á Dân
李岐山=Lý Kỳ Sơn
拉克鲁瓦=Lacroix
相羽英介=Aiba Eisu
程遵业=Trình Tuân Nghiệp
程玄渊=Trình Huyền Uyên
相羽川=Aiba Kawa
相羽亚美=Aiba Yami
廖正清=Liêu Chính Thanh
白云喧=Bạch Vân Huyên
周清华=Chu Thanh Hoa
爱小小=Yêu Tiểu Tiểu
安小小=An Tiểu Tiểu
相羽雄介=Aiba Yūsuke
顾大师=Cố đại sư
泷野瑛祐=Takino Eisuke
伊原理花=Ihara Rika
越水遥=Koshimizu Ririka
小百合=Yuriko-chan
他的人=hắn người
后辈君=kouhai-kun
上田正南=Ueda Masao
竹内拓实=Takeuchi Takumi
春日香苗=Haruhi Kanae
二宫诗织=Ninomiya Shiori
suki君=Suki-kun
多崎司=Tasaki Tsukasa
远野幸子=Tōno Sachiko
栖川新浩=Sugawa Arata
栖川唯=Sugawa Kaya
小樱良=Sakura-chan
星野花见=Hoshino Hanami
栗山樱良=Kuriyama Sakura
村上水色=Murakami Mizuiro
皇甫嵩=Hoàng Phủ Tung
程光明=Trình Quang Minh
程缦缦=Trình Man Man
程德真=Trình Đức Chân
天际庞家=Chân Trời Bàng gia
宫小美女=Cung tiểu mỹ nữ
洛大高手=Lạc đại cao thủ
白云暄=Bạch Vân Huyên
唐乔然=Đường Kiều Nhiên
安维琪=An Duy Kỳ
蒙代尔=Mundell
轮子妈=Sivir
卡牌大师=TF
犹格索托斯=Yog-Sothoth
唐泽华=Đường Trạch Hoa
唐老板=Đường lão bản
德雷福斯=Dreyfus
唐小姐=Đường tiểu thư
罗特希尔德=Rothschild
薛小蝶=Tiết Tiểu Điệp
火千树=Hoả Thiên Thụ
帕尔东=Pardon
本齐乌埃=Penthièvre
儒尔维尔=Joinville
内穆尔=Nemours
费迪南=Ferdinand
江大哥=Giang đại ca
朱塞佩=Chu Tắc Bội
宋苑苑=Tống Uyển Uyển
王四百=Vương Tứ Trăm
蒙莫朗西=Montmorency
李加成=Lý Gia Thành
帕麦斯顿=Palmerston
王彤彤=Vương Đồng Đồng
陈叔叔=Trần thúc thúc
周晓红=Chu Hiểu Hồng
未来魔=Vị Lai ma
星云子=Tinh Vân tử
明珠姐=Minh Châu tỷ
贝尔乔若索=Belgiojoso
翠芙吉奥=Trivulziodi
克里斯蒂娜=Christina
眼见夏尔=Nhãn Kiến Hạ Nhĩ
于知乐=Vu Tri Lạc
梅纳德=Maynard
莫里斯=Morris
柯尔特=Colt
于！知！乐=Vu! Tri! Lạc
李珞倾=Lý Lạc Khuynh
吉斯凯=Gisquet
热罗姆=Jérôme
弗勒里=Fleury
腓特烈=Friedrich
邵淑华=Thiệu Thục Hoa
雪媚儿=Tuyết Mị Nhi
吴佳妍=Ngô Giai Nghiên
刘佳妍=Lưu Giai Nghiên
夏枕月=Hạ Chẩm Nguyệt
麦克白=Macbeth
激光雨=mưa laser
龙葵素=Long Quỳ Tố
仇球球=Cừu Cầu Cầu
蛮头人=man đầu nhân
九狐宫=Cửu Hồ cung
厉仙子=Lệ tiên tử
罗长老=La trưởng lão
吴庭熹=Ngô Đình Hi
郑仙师=Trịnh tiên sư
裴鸿年=Bùi Hồng Niên
郑荆山=Trịnh Kinh Sơn
黑桐干也=Kokutou Mikiya
苍崎青子=Aozaki Aoko
秽血死神=Uế Huyết tử thần
黄老头=Hoàng lão đầu
黄志华=Hoàng Chí Hoa
血红满月=Huyết Hồng Mãn Nguyệt
七公子=thất công tử
丹维尔=Danville
莫蒂埃=Mortier
弗朗索瓦=François
塞雷昂=Sereon
德·博旺=de Beauvain
艾米丽=Emily
季莫申科=Tymoshenko
贡斯当=Constant
普拉斯兰=Praslin
舒瓦瑟尔=Choiseul
加百利=Gabriel
瓦德西=Waldersee
施泰因梅茨=Steinmetz
斯特拉塞=Strasser
拉波塔=La Porta
塞巴斯蒂亚尼=Sébastiani
尼米兹=Nimitz
克劳斯=Klaus
范德格里夫特=Vandegrift
阿切尔=Archer
瓦尔帕莱索=Valparaíso
夏英明=Hạ Anh Minh
吕西安=Lucien
弗里德兰=Friedland
梯也尔=Thiers
林德伯格=Lindbergh
埃琳娜=Yelena
王金龙=Vương Kim Long
路易十五=Louis XV
蓬巴杜=Pompadour
德·特雷维尔=de Tréville
露易丝=Louise
苏尔特=Soult
苏叶子=Tô Diệp Tử
埃莉萨=Elisa
阿诗黛=Estelle
达尔马提亚=Dalmatia
布罗伊=Broglie
斩首者=người chém đầu
克劳恩特=Croente
苏欢欢=Tô Hoan Hoan
王静美=Vương Tĩnh Mỹ
陈小萱=Trần Tiểu Huyên
妃莉娅=Feilia
刘子轩=Lưu Tử Hiên
李建国=Lý Kiến Quốc
李康国=Lý Khang Quốc
白回音=Bạch Hồi Âm
爱弥儿=Emile
欧阳林=Âu Dương Lâm
科伦扎=Kolenza
李新红=Lý Tân Hồng
李奶奶=Lý nãi nãi
李香君=Lý Hương Quân
爱染明王=Ái Nhiễm Minh Vương
蛊=cổ
安南藏=An Nam Tàng
李各由=Lý Các Do
澹台训=Đạm Đài Huấn
澹台游=Đạm Đài Du
安品堂=An Phẩm Đường
裴紫琪=Bùi Tử Kỳ
莫学姐=Mạc học tỷ
严川豪=Nghiêm Xuyên Hào
赵国山=Triệu Quốc Sơn
马斯迦尔=Masgar
阿耨多罗=A Nậu Đa La
三藐三菩提=Ba Miểu Ba Bồ Đề
莫宝宝=bé Mạc
帕修斯=Perseus
秦、白=Tần, Bạch
聂院长=Nhiếp viện trưởng
福格特=Vogt
林毅坚=Lâm Nghị Kiên
糯米团子=Nắm Gạo Nếp
糯米团=Nắm Gạo Nếp
许阿姨=Hứa a di
林佳友=Lâm Giai bạn
孙渭虎=Tôn Vị Hổ
陆小小=Lục Tiểu Tiểu
徐友汶=Từ Hữu Vấn
王承赋=Vương Thừa Phú
莫大小姐=Mạc đại tiểu thư
李世施=Lý Thế Thi
江流儿=Giang Lưu Nhi
祁桐伟=Kì Đồng Vĩ
如意如愿=Như Ý Như Nguyện
白素言=Bạch Tố Ngôn
奥摩尔=Omor đế quốc
卡尔弗兰=Karfran
赵承德=Triệu Thừa Đức
子衿姐=Tử Khâm Tỷ
乔姐姐=Kiều tỷ tỷ
秦建章=Tần Kiến Chương
禅那伽=Thiền Na Già
聂爷爷=Nhiếp ông nội
聂棋圣=Nhiếp kỳ thánh
聂卫屏=Nhiếp Vệ Bình
聂会长=Nhiếp hội trưởng
莫憨憨=Mạc Khờ Khờ
洛扎卡=Lozaka
金毛小狮王=Kim Mao Tiểu Sư Vương
特雷蛇=Teresa
特雷神=Teresa
卡司金=Kaskin
莫三岁=Mạc Ba Tuổi
钱爷爷=Tiền ông nội
宋家慧=Tống Gia Tuệ
伽兰德=Garand
肾果4=iPhone 4
张四岁=Trương Bốn Tuổi
陈天元=Trần Thiên Nguyên
小繁弱=tiểu Phồn Nhược
格洛德=Gerrod
泰罗德=Tyrod
马格诺=Magno
保得利=Portcullis
格纳若=Gnaro
席尔瓦多=Silvada
阿卓克=Azrok
巴尔地摩=Baltimore
克丝琴娃=Krzincova
英格瑞=Ingre
帕里斯=Paris
格尼慈=Genici
妹妹如愿=muội muội Như Nguyện
两小只=hai cô nhóc
蒙德罗=Mondela
莫姐姐=Mạc tỷ tỷ
郑佩菱=Trịnh Bội Lăng
沈清如=Thẩm Thanh Như
苏宛璇=Tô Uyển Toàn
白幼狸=Bạch Ấu Ly
周老太太=Chu lão thái thái
钱老大夫=Tiền lão đại phu
秦承文=Tần Thừa Văn
承文承武=Thừa Văn Thừa Võ
秦承武=Tần Thừa Võ
罗恩纳克=Ronak
林如愿=Lâm Như Nguyện
林如意=Lâm Như Ý
莫忘归=Mạc Vong Quy
何清书=Hà Thanh Thư
秦晚台=Tần Vãn Đài
张繁弱=Trương Phồn Nhược
何台长=Hà đài trưởng
小莫莫=tiểu Mạc Mạc
李沧海=Lý Thương Hải
伊利丹=Illidan
念奴娇=Niệm Nô Kiều
苏幕李=Tô Mạc Lý
赵铁柱=Triệu Thiết Trụ
阿尔帕德·杜尧姆=Árpád · Dullaume
拉沃尔省=tỉnh Laver
星龙之王=Tinh Long Chi Vương
顾建新=Cố Kiến Tân
阿尔托=Artor
亚瑟王=Vua Arthur
小亚瑟王=Vua Arthur Nhỏ
小不点王=Vua Tí Hon
黄段子侍女=Hoàng Đoạn Tử thị nữ
蔺江仙=Lận Giang Tiên
王红梅=Vương Hồng Mai
加百列=Gabriel
谢伶俐=Tạ Linh Lị
韩英爱=Hàn Anh Ái
于其明=Vu Kỳ Minh
赵婷婷=Triệu Đình Đình
林洛然=Lâm Lạc Nhiên
程中原=Trình Trung Nguyên
陈大红=Trần Đại Hồng
钱诗诗=Tiền Thi Thi
康世安=Khang Thế An
顾正宇=Cố Chính Vũ
马华龙=Mã Hoa Long
李子善=Lý Tử Thiện
朱宏志=Chu Hoành Chí
释永信=Thích Vĩnh Tín
贾言令=Giả Ngôn Lệnh
林丽雯=Lâm Lệ Văn
李爱绮=Lý Ái Khởi
沈佩菱=Thẩm Bội Lăng
林雯丽=Lâm Văn Lệ
赵琳阳=Triệu Lâm Dương
丁乐歆=Đinh Nhạc Hâm
周德凯=Chu Đức Khải
郭存忠=Quách Tồn Trung
白文昌=Bạch Văn Xương
比卡里=Biccari
瓦片特=Tingtile
可雷欧=Coreo
富坎特=Fucant
美佳丝=Meijiasi
杰西弗=Jessie
吉诺尔=Ginor
牛因斯坦=Niueinstein
那札特=Nazat
马祖科=Mazuko
徐周济=Từ Chu Tế
徐济周=Từ Tế Chu
佛霓裳=Phật Nghê Thường
白贵妃=Bạch quý phi
莫繁弱=Mạc Phồn Nhược
阿拉密斯=Aramis
秦大头=Tần Đầu To
周奶奶=Chu nãi nãi
华正德=Hoa Chính Đức
谭红旗=Đàm Hồng Kỳ
顾老板=Cố lão bản
乔小奴=Kiều Tiểu Nô
南宫问雅=Nam Cung Vấn Nhã
东方铁心=Đông Phương Thiết Tâm
马丽华=Mã Lệ Hoa
苏慕李=Tô Mộ Lý
秦如燕=Tần Như Yến
秦如月=Tần Như Nguyệt
秦繁弱=Tần Phồn Nhược
李存思=Lý Tồn Tư
万志远=Vạn Chí Viễn
王灵雁=Vương Linh Nhạn
猪无戒=Trư Vô Giới
杨丽娜=Dương Lệ Na
前院长=Tiền viện trưởng
楚悠悠=Sở Du Du
张晋云=Trương Tấn Vân
菲利克斯=Felix
余北斗=Dư Bắc Đẩu
莫女士=Mạc nữ sĩ
秦安易=Tần An Dịch
大自在渡人妙箓=Đại Tự Tại Độ Nhân Diệu Lục
上决浮云=Thượng Quyết Phù Vân
黄应吕=Hoàng Ứng Lã
李和平=Lý Hoà Bình
律化娜=Rihanna
亥朱儿=Hợi Chu Nhi
李宗卫=Lý Tông Vệ
徐韵寒=Từ Vận Hàn
裴子淇=Bùi Tử Kỳ
黄小民=Hoàng Tiểu Dân
李学刚=Lý Học Cương
周云海=Chu Vân Hải
周云帆=Chu Vân Phàm
多晓静=Đa Hiểu Tĩnh
陈小彤=Trần Tiểu Đồng
李宗德=Lý Tông Đức
李荣兴=Lý Vinh Hưng
赵日天=Triệu Nhật Thiên
白人屠=Bạch Nhân Đồ
向小园=Hướng Tiểu Viên
释广德=Thích Quảng Đức
王保保=Vương Bảo Bảo
唐小妹=Đường tiểu muội
灭世魔星=Diệt Thế Ma Tinh
苏幕遮=Tô Mạc Già
赢运昌=Doanh Vận Xương
黎柒邪=Lê Thất Tà
王谋人=Vương Mưu Nhân
陈青虹=Trần Thanh Hồng
赢若樱=Doanh Nhược Anh
华阳公主=Hoa Dương công chúa
张东明=Trương Đông Minh
林姐姐=Lâm tỷ tỷ
小凤仙=Tiểu Phượng Tiên
白少爷=Bạch thiếu gia
子姚娘=Tử Diêu Nương
秦小林=Tần Tiểu Lâm
何小妨=Hà Tiểu Phương
王公子=Vương công tử
许莫负=Hứa Mạc Phụ
白恶棍=Bạch ác ôn
雪斋剑=Tuyết Trai Kiếm
沈东元=Thẩm Đông Nguyên
白将军=Bạch tướng quân
西北王=Tây Bắc Vương
张锦文=Trương Cẩm Văn
苏强文=Tô Cường Văn
林弃霜=Lâm Khí Sương
白卫国=Bạch Vệ Quốc
唐小婉=Đường Tiểu Uyển
白小天=Bạch Tiểu Thiên
律化娜西琳=Luật Hoá Na Tây Lâm
嬴若樱=Doanh Nhược Anh
小泽泽=Tiểu Trạch Trạch
伽罗兰=Garland
李立峰=Lý Lập Phong
蔡卓文=Thái Trác Văn
张立伟=Trương Lập Vĩ
李成仁=Lý Thành Nhân
白婆婆=Bạch bà bà
徐春晖=Từ Xuân Huy
石奇峰=Thạch Kỳ Phong
江湾区=Giang Loan khu
张雅丽=Trương Nhã Lệ
高白梅=Cao Bạch Mai
陶承欣=Đào Thừa Hân
孙继柔=Tôn Kế Nhu
白！小！天！=Bạch! Tiểu! Thiên!
普雷斯=Press
窦胜男=Đậu Thắng Nam
劳伦斯·李=Lawrence · Lee
黎九重=Lê Cửu Trùng
赵八两=Triệu Bát Lượng
赢若英=Doanh Nhược Anh
易鉴莲=Dịch Giám Liên
白云峰=Bạch Vân Phong
天绝地灭=Thiên Tuyệt Địa Diệt
丁师姐=Đinh sư tỷ
丁君仪=Đinh Quân Nghi
焰灵鸡=Diễm Linh Kê
天绝，地灭=Thiên Tuyệt, Địa Diệt
天绝地灭刺=Thiên Tuyệt Địa Diệt Thích
双绝门=Song Tuyệt Môn
天绝刺=Thiên Tuyệt Thích
地灭刺=Địa Diệt Thích
焰灵姬=Diễm Linh Cơ
顾小青=Cố Tiểu Thanh
梅长红=Mai Trường Hồng
龙傲皇=Long Ngạo Hoàng
李莫莫=Lý Mạc Mạc
九湖宫=Cửu Hồ Cung
狗师弟=Cẩu sư đệ
慕容诗=Mộ Dung Thi
雯沉萱=Văn Trầm Huyên
周文斌=Chu Văn Bân
何大作家=Hà đại tác gia
李迎珍=Lý Nghênh Trân
赵景阳=Triệu Cảnh Dương
无尘子=Vô Trần tử
玄元道尊=Huyền Nguyên Đạo Tôn
徐北城=Từ Bắc Thành
武博士=Võ tiến sĩ
唐小宛=Đường Tiểu Uyển
何天帝=Hà Thiên Đế
许相师=Hứa thầy tướng
王超清=Vương Siêu Thanh
吴秋意=Ngô Thu Ý
年鸿安=Niên Hồng An
马洛夫=Marlov
蔡志远=Thái Chí Viễn
林剑圣=Lâm Kiếm Thánh
柳慕白=Liễu Mộ Bạch
胡文虎=Hồ Văn Hổ
杨景新=Dương Cảnh Tân
韩一夏=Hàn Nhất Hạ
柳子越=Liễu Tử Việt
纸役师=Chỉ Dịch Sư
刘此垂=Lưu Thử Thuỳ
刘挂匹=Lưu Treo Thớt
命运的后颈皮=Da gáy vân mệnh
金光镇=Kim Kwang-jin
卢武铉=Roh Moo-hyun
郑淳元=Jeong Soon-won
金雪儿=Kim Tuyết Nhi
凯罗尔=Cayrols
鲜大志=Tiên Đại Chí
邹伟昌=Trâu Vĩ Xương
北飞路=đường Bắc Phi
司马小二=Tư Mã Tiểu Nhị
小安雅=tiểu An Nhã
进化剂=Thuốc tiến hoá
狗道士=Cẩu đạo sĩ
赵静静=Triệu Tĩnh Tĩnh
黄飘飘=Hoàng Phiêu Phiêu
狗前辈=Cẩu tiền bối
张屠户=Trương đồ tể
王地主=Vương địa chủ
周铭业=Chu Minh Nghiệp
俞晴晴=Du Tình Tình
贾旭阳=Giả Húc Dương
李飞壶=Lý Phi Hồ
五大宗师=Ngũ Đại Tông Sư
朴山多拉=Park Sandara
朴德爽=Park Dae-sang
白纨绔=Bạch hoàn khố
万志康=Vạn Chí Khang
杜蓝蓝=Đỗ Lam Lam
第七重奏01=Đệ Thất Trùng Tấu 01
东方快鸟=Đông Phương Khoái Điểu
花仙子=Hoa Tiên Tử
黄韵岐=Hoàng Vận Kỳ
龚舜华=Cung Thuấn Hoa
布兰卡=Blanca
村长万岁=Thôn Trưởng Vạn Tuế
李弘基=Lee Hong-gi
国王陛下=Quốc Vương Bệ Hạ
申宇哲=Shin Woo-chul
祝轻云=Chúc Khinh Vân
负是非=Phụ Thị Phi
沈恩京=Shim Eun-kyung
角川春树=Haruki Kadokawa
朴明秀=Park Myung-soo
一米八=một mét tám
韩成豪=Han Seong-ho
姜明石=Kang Myung-seok
安玄石=An Hyun-seok
金明敏=Kim Myung-min
金惠子=Kim Hye-ja
卫浩然=Vệ Hạo Nhiên
卫婕馨=Vệ Tiệp Hinh
王小慧=Vương Tiểu Tuệ
王思青=Vương Tư Thanh
吴芸芸=Ngô Vân Vân
张蒙蒙=Trương Mông Mông
严嘉鱼=Nghiêm Gia Ngư
韩教授=Hàn giáo sư
郑亨敦=Jeong Hyeong-don
安捷伦=Agilent
马保国=Mã Bảo Quốc
郑清鉴=Trịnh Thanh Giám
何大厨=Hà đầu bếp
何老师=Hà lão sư
何大仙=Hà đại tiên
摩尔斯=Morse
季羡林=Quý Tiễn Lâm
小林子=tiểu Lâm Tử
黄大爷=Hoàng đại gia
泡泡玛特=Pop Mart
何大少=Hà đại thiếu
赵露思=Triệu Lộ Tư
严芷涵=Nghiêm Chỉ Hàm
何乐勤=Hà Nhạc Cần
赵博文=Triệu Bác Văn
特洛赞=Trozan
孙丹菲=Son Dam-bi
宋仲基=Song Joong-ki
车胜宰=Cha Seoung-jae
瓦尔卡斯=Valcarce
吴钟赫=Oh Jong-hyuk
何国权=Hà Quốc Quyền
剑姬A梦=Dorakiếmcơ
伊古拉=Igura
恩莱科=Anraku
安德莱耶=Andreyer
伏斯洛达=Fusrodah
洛依丝=Lois
边伯贤=Byun Baek-hyun
边白贤=Byun Baek-hyun
沈昌珉=Shim Chang-min
姜宇斌=Kang Woo-bin
朴有天=Park Yoochun
金在中=Kim Jae-joong
金俊秀=Kim Jun-su
权相佑=Kwon Sang-woo
严正花=Uhm Jung-hwa
十里星=Thập Lý Tinh
森川羽=Sâm Xuyên Vũ
高坂真木=Cao Phản Chân Mộc
杨智媛=Yang Ji-won
李智雅=Lee Ji-ae
薛景求=Sol Kyung-gu
关重山=Quan Trọng Sơn
李明博=Lee Myung-bak
顾先生=Cố tiên sinh
王大圈=Vương Đại Khuyên
赵巨涛=Triệu Cự Đào
程微芸=Trình Vi Vân
繁星国度=Phồn Tinh Quốc Độ
埃尔默=Elmer
人气歌谣=Inkigayo
科比特=Corbett
乔纳斯=Jonas
音乐银行=Music Bank
斯图尔特=Stewart
四柱神=Tứ Trụ Thần
斯诺登=Snowden
库林顿=Clinton
白智英=Baek Ji-young
海灵顿=Herrington
比利海灵顿=Billy Herrington
崔秀钟=Choi Soo-jong
唐纳德·李=Donald Lee
弗罗里达=Florida
科林·李=Colin Lee
陈梓妍=Trần Tử Nghiên
江临风=Giang Lâm Phong
掬风姐姐=Cúc Phong tỷ tỷ
掬风前辈=Cúc Phong tiền bối
马斯拉=Masla
艾尔伯特=Albert
蒙警官=Mông cảnh quan
刑玉林=Hình Ngọc Lâm
邢玉林=Hình Ngọc Lâm
周正毅=Chu Chính Nghị
艾尔格林=Elgerin
艾尔德斯=Aldes
科赫先生=Khoa Hách tiên sinh
吴藤兰=Ngô Đằng Lan
玉珠铉=Ock Joo-hyun
菲奥娜=Fiona
马修-李=Matthew Lee
杜鲁门=Truman
万磁王=Magento
全慧彬=Jeon Hye-bin
郑允浩=Jung Yun-ho
桑德罗=Sandro
丹妮斯=Denise
雷风合=Lôi Phong Hợp
银老板=Ngân lão bản
艾尔格=Elger
澹台彻=Đạm Đài Triệt
金承勋=Kim Seung-Hoon
张紫妍=Jang Ja-yeon
朴志胤=Park Ji-yoon
金镇奎=Kim Jin-kyu
李真圭=Lee Jin-kyu
高雅拉=Go Ara
萧楚女=Tiêu Sở Nữ
宋清曼=Tống Thanh Mạn
陈斯年=Trần Tư Niên
尹导演=đạo diễn Yoon
巧丫头=Xảo nha đầu
朴素妍=Park So-yeon
尹济均=Yoon Je-kyoon
拉克丝=Lux
八月小幼狐=Bát Nguyệt Tiểu Ấu Hồ
一月小幼猫=Nhất Nguyệt Tiểu Ấu Miêu
赵依依=Triệu Y Y
徐怼怼=Từ Bật Bật
快乐索=Da Xua
韩亦可=Hàn Diệc Khả
格罗夫斯=Groves
哈利法克斯子爵=Halifax tử tước
哈利法克斯=Halifax
韩喷子=Hàn Thánh Chửi
横井忠雄=Tadao Yokoi
恩利克=Enrico
诗仙女=Thi Tiên Nữ
韩奶奶=Hàn Nãi Nãi
卡尔·豪斯霍费尔陆军大将=Karl Haushofer lục quân đại tướng
卡尔·豪斯霍费尔=Karl · Haushofer
横井少将=Yokoi  thiếu tướng
塔西尼=Tassigny
秦晓真=Tần Hiểu Chân
布洛赫=Bloch
英法俄=Anh Pháp Nga
摩根索=Morgenthau
小笠原桑=Ogasawara-san
重光葵=Mamoru Shigemitsu
郑可想=Trịnh Khả Tưởng
鲁道夫·赫斯=Rudolf  · Hess
斯塔夫罗波尔=Stavropol
塔斯社=TASS
沃斯克列先斯克=Voskresensk
卡图佐夫=Katuzov
奥斯塔绍沃=Ostashevo
塞尼·洛泰尔=Segni · Lothaire
马豪斯=Matthäus
洛伦佐·霍尔莫斯=Lorenzo · Holmes
小笠原=Ogasawara
泷谷桑=Takiya-san
真希酱=Maki-chan
程大雷=Trình Đại Lôi
程雪晴=Trình Tuyết Tình
早川酱=Hayakawa-chan
佐野酱=Sano-chan
希灵帝国=Hi Linh đế quốc
影子城=Shadow City
宏世界=Macroworld
希灵使徒=Hi Linh sứ đồ
兄长大人=onii-sama
比留佐夫=Biryuzov
泷谷爱=Takiya Ai
梁赞州=Ryazan
戈沃罗夫=Govorov
沃洛拉姆斯克=Volokolamsk
巴尔克=Balck
科科佩夫=Kokopev
维索科夫斯克=Vysokovsk
克雷洛夫=Krylov
佐野桑=Sano-san
姜导演=đạo diễn Kang
叶菲莫维奇=Yefimovich
卡图科夫=Katukov
费尔斯托夫=Felstorf
格奥尔吉耶维奇=Georgiyevich
博罗维奇=Borovichi
奥泽尔基=Ozerki
菲罗沃=Firovo
“洋娃娃”=“Püppchen”
五一镇=Parvomay
瓦代尔=Valday
乔洛克=Cholock
刘莉莉=Lưu Lily
陈晓芬=Trần Hiểu Phân
田健华=Điền Kiện Hoa
李书平=Lý Thư Bình
卡普佩尔=Kappel
乌里扬诺夫斯克=Ulyanovsk
安德烈波尔=Andreapol
安德烈亚波尔=Andreapol
安德烈亚波夫=An Đức Liệt Á Ba Nhĩ
瓦尔代=Valday
斯科尔内兹=Skorzeny
托尔诺克=Szolnok
亚尔采夫=Yartsevsky
利库斯拉夫=Likhoslavl
沃罗乔克=Vorochok
库夫希诺夫=Kuvshinovsky
季耶夫=Diev
克洛奇科夫=Klochkov
科兹洛沃=Kislovodsk
林绉舞=Lâm Trứu Vũ
郑志超=Trịnh Chí Siêu
茂小时=Mậu Tiểu Thời
瓦连尼科夫=Varennikov
金十岁=Kim mười tuổi
朴仁静=Park In-jung
奈奈酱=Nana-chan
曾兆丁=Tằng Triệu Đinh
松下君=Matsushita-kun
曾全明=Tằng Toàn Minh
薛阳易=Tiết Dương Dịch
伊织酱=Iori-chan
椎名君=Shiina-kun
天海桑=Tenkai-san
文字君=Văn Tự-kun
天海诚=Tenkai Makoto
三小姐=Tam tiểu thư
南哥哥=Nam ca ca
萧三爷=Tiêu tam gia
苏逐流=Tô Trục Lưu
萧妖jing=Tiêu yêu tinh
含恩静=Hahm Eun-jung
蜜拉丝=Milath
赵寅成=Jo In-sung
黄先生=Hoàng tiên sinh
孙先生=Tôn tiên sinh
张根硕=Jang Keun-suk
林秀晶=Im Soo-jung
金南镇=Kim Nam-jin
苏志燮=So Ji-sub
金秀路=Kim Su-Ro
朴艺珍=Park Ye-jin
刘在石=Yoo Jae-Seok
天海君=Tenkai-kun
绘里香=Erika
千奈酱=Yukina-chan
季无烦=Quý Vô Phiền
权志龙=Kwon Ji-yong
金泫雅=Kim Hyun-ah
莫菲耶维奇=Timofeyevich
亚佐夫=Yazov
勒热夫=Rzhev
科斯莫杰扬斯科夫=Kosmodemyansky
瓦西里耶维奇=Vasilyevich
潘菲洛夫=Panfilov
李云奉先=Lý Vân Phụng Tiên
金太软=Kim Tae-yon
朴宣映=Park Sun-young
维杰布斯克=Vitebsky
林云城=Lâm Vân Thành
全宇蓝=Jeon Woo-ram
姜虎东=Kang Ho-dong
金导演=đạo diễn Kim
金奎泰=Kim Khuê Thái
李英石=Lee Young-seok
张承恩=Jang Seo-eun
裴秀智=Bae Su-ji
裴兔子=Bae Thỏ
王锡玄=Wang Seok-hyeon
朴宝英=Park Bo-young
李启武=Lý Khải Võ
林灵素=Lâm Linh Tố
约德尔=Yodel
俞勇镇=Yoo Young-jin
彼得罗夫=Petrov
贝利亚=Belial
亚罗斯拉夫斯基=Yaroslavsky
乌德特=Udet
里希特霍芬=Richthofen
吉尔伯特群岛=quần đảo Gilbert
“银河”=“Ginga”
东方神起=DBSK
朴仁熙=Park In-hee
姜炯哲=Kang Hyeong-cheol
李小白=Lý Tiểu Bạch
刘世美=Liu Shi Mei
司马季预=Tư Mã Quý Dự
“吞龙”=Nakajima Ki-49
江草繁太郎=Ekusa Shintaro
江草繁隆=Takashige Ekusa
龟井凯夫=Kamei Yoshio
丰后水道=kênh đào Bungo
约瑟夫·肯尼迪=Joseph · Kennedy
卡拉汉=Callaghan
蒙大拿=Montana
元始天魔=Nguyên Thuỷ Thiên Ma
金伦加=Ginnunga
卡奥斯=Chaos
弗丽嘉=Frigg
赫尔穆特=Hellmuth
齐柏林=Zeppelin
“齐柏林”号=Zeppelin
李秉宪=Lee Byung-hun
哎一古=Aigu
车太贤=Cha Tae-hyun
郭在容=Kwak Jae-yong
金敏豪=Kim Min-ho
金镇万=Kim Jin-man
莫老师=Mạc lão sư
陆展元=Lục Triển Nguyên
杨如意=Dương Như Ý
李卫民=Lý Vệ Dân
贝尔格拉诺将军号=General Belgrano
法雷尔=Farrell
“大井”号=Ōi
阿利·伯克准将=Arleigh Burke chuẩn tướng
阿利·伯克=Arleigh Burke
霍斯特·派普=Horst Peiper
尼古拉斯·冯·法尔肯霍斯特=Nikolaus von Falkenhorst
普列斯特斯=Prestes
普列斯特斯。=Prestes
贝希斯特加登=Berchtesgaden
南里奥格兰德州=Rio Grande do Sul
热图里奥=Getúlio
北里约格朗德=Rio Grande do Norte
阿道夫=Adolf
里瓦达维亚级=Rivadavia cấp
里瓦达维亚=Rivadavia
艾薇塔=Evita
杜亚尔特=Duarte
雷无桀=Lôi Vô Kiệt
大井号=Ōi
北上号=Kitakami
文森斯=Vincennes
“滩风”号=Nadakaze
昆西号=Quincy
“鸟海”号=Chōkai
“昆西”号=Quincy
“古鹰”号=Furutaka
特伦斯=Terence
迈耶斯=Meyers
高雄级=Takao cấp
萨凡纳=Savannah
李阿姨=Lý a di
日本海军=Nhật Bản hải quân
火控雷达=radar điều khiển hoả lực
十三姨=dì Mười Ba
“加古”=“Kako”
“青叶”=“Aoba”
“衣笠”=“Kinugasa”
柳芊芊=Liễu Thiên Thiên
柳月月=Liễu Nguyệt Nguyệt
火控电探=radar điều khiển hoả lực
岛风级=Shimakaze cấp
里奇蒙德=Richmond
“岛风”=“Shimakaze”
江风号=Kawakaze
峰风级=Minekaze cấp
白露号=Shiratsuyu
夕张号=Yuubari
鸟海号=Chōkai
衣笠号=Kinugasa
军令部长=quân lệnh bộ trưởng
日清战争=chiến tranh Thanh Nhật
神重德=Shigenori Kami
三川军一=Gunichi Mikawa
金贤珠=Kim Hyun-joo
清水光美=Mitsumi Shimizu
小松辉久=Teruhisa Komatsu
高木武雄=Takeo Takagi
科本斯=Cowpens
布雷森林=Bretton Wood
邓尼茨=Doenitz
庇隆主义党=đảng Justicialist
考迪罗=Caudillo
胡安·庇隆=Juan · Perón
海因茨=Heinz
圣胡安=San Juan
山下奉文=Tomoyuki Yamashita
仁科芳雄=Yoshio Nishina
安田武雄=Takeo Yasuda
战略情报局长=cục trưởng cục chiến lược tình báo
安承中=An Seo-jong
多诺万=Donovan
安玄宰=An Hyun-ja
佐藤太郎=Taro Sato
林弥一郎=Yaichirō Hayashi
德川家康=Tokugawa Ieyasu
丰臣秀吉=Toyotomi Hideyoshi
德川好敏=Yoshitoshi Tokugawa
师团长=sư đoàn trưởng
阿诺德=Arnold
华盛顿=Washington
陈中原=Trần Trung Nguyên
初春镇=Sơ Xuân trấn
警惕教堂=Cảnh Giác giáo đường
旧调小组=Cựu Điều tiểu tổ
奥尔康斯=Olcons
朱先生=Chu tiên sinh
许叔叔=Hứa thúc thúc
刑部官员=Hình Bộ quan viên
天地会成员=thành viên Thiên Địa Hội
顾南升=Cố Nam Thăng
雷奥教=Leo
邹老师=Ngưu lão sư
邹老头=Ngưu lão đầu
西格鲁=Sigur
西尔法=Silfa
艾斯特雷=Estre
程维新=Trình Duy Tân
程晋阳=Trình Tấn Dương
爱因斯=Eins
张怡萍=Trương Di Bình
宁宁姐=Ninh Ninh tỷ
妖姬姐姐=Yêu Cơ tỷ tỷ
卡雷奥=Carreo
北府军=Bắc Phủ quân